Gg, Gg, Gs^Fds, Gs^Fds, Gs^Fds, Gs^Fds, Gs^Fms, Gll^Fp, Gs^Fms, Gg, Gs^Efm, Cv, Gs^Efm, Gs, Gs^Fds, Gs^Fds, Gs^Fds, Gg, Gg^Efm, Gs, Gs^Efm, Gs, Gs, Gs^Fds, Gs^Fds, Gs^Fds, Gg, Gs^Fds, Gll^Fp, Gll^Fp, Gll, Gg^Es, Gs^Efm, Gg, Gg, Gg, Gs^Fds, Gg, Gs^Efm, Gg, Gs^Fds, Gs^Fds, Gs^Fds, Gs^Fds, Gs^Fds, Gs, Gs^Fds, Gs^Fds, Gs^Fds, Gs^Fds, Gs^Fds, Gs^Fds
Gs^Fds, Gs^Fds, Gg^Efm, Gg^Efm, Gs^Edb, Gs, Gg^Efm, Gll^Fp, Gll^Em, Gs^Fds, Gg, Gg, Gs^Efm, Gs, Gg^Efm, Gg, Gs, Gg^Efm, Gs^Fds, Gs^Efm, Gg, Gs^Efm, Gs, Gs, Gg^Es, Gg, Gs, Gs^Fds, Gs^Fds, Gs^Fds, Gg, Gg^Efm, Gg^Es, Gs^Efm, Gg, Gs^Efm, Gg^Efm, Gg, Hh, Hh, Gs^Fds, Gs^Efm, Gs, Gs^Fds, Gs^Fds, Gs^Efm, Gg^Es, Gs^Fds, Gg^Efm, Gs^Fds, Gs^Fds, Gs^Fds
Gg, Gg^Es, Gs^Fds, Gs^Efm, Gg^Edb, Gs^Es, Gg, Gg^Efm, Gs^Fds, Gs^Fds, Gs^Efm, Gg^Es, Gs, Gg^Efm, Gg, Gs^Fds, Gll^Fp, Gs, Gs^Efm, Gs^Fds, Gs^Fds, Gs^Fds, Gs^Efm, Gg^Efm, Gs^Fds, Gs^Fds, Gs^Fds, Gs, Gg^Efm, Gg^Efm, Gs, Gs^Fds, Gs^Fds, Gs, Gs^Fds, Gs^Fds, Gs^Fms, Gg^Efm, Gs^Fds, Mm, Mm, Hh, Gs^Fds, Hh, Gg^Efm, Gs, Gs, Gs^Efm, Gs, Gs^Fds, Gs^Fds, Gs^Efm
Gg^Efm, Gs^Fds, Gs^Fds, Gs^Fds, Gs, Cvr^Edb, Kvr, Cvr^Edb, Cvr^Edb, Gs^Edb, Gg^Efm, Gg, Gg^Ve, Gs, Gs^Fds, Gs^Fms, Gll^Fp, Gll^Fp, Gs^Fms, Gs^Efm, Gs^Fds, Gg, Gg^Efm, Gg^Efm, Gs^Fds, Gs^Efm, Gs^Fds, Gs^Fds, Gg, Gg, Gs^Efm, Gs^Efm, Gg, Gg^Efm, Gs^Fms, Gll^Fp, Gll^Fp, Gs^Fds, Gs^Fds, Mm, Mm, Mm, Mm, Mm, Hh, Gs^Efm, Gs^Fds, Gs, Gs^Efm, Gs^Fds, Gs^Efm, Gs^Fds
Gs^Fds, Gs^Fds, Gs^Efm, Gs^Efm, Gs^Edb, Gg^Efm, Cvr^Edb, 3 Ker, Cer^Edb, Gs^Edb, Gs^Edb, Gg^Efm, Gs, Gg^Efm, Gg^Efm, Gs^Fds, Gs^Fds, Gs^Fms, Gll^Fp, Gg, Gs, Gs, Gs^Fds, Gs^Fds, Gs, Gs^Fds, Gs^Fds, Gs^Fds, Gs^Fds, Gs^Efm, Gg, Gs^Efm, Gs, Gs^Fds, Hh, Gll^Fp, Gll^Em, Mm, Wwr, Wwf^Es, Wo, Wwf, Wwf^Es, Hh, Mm, Gs^Fds, Hh, Gs^Fds, Gs^Efm, Gs^Efm, Gs^Fds, Gg^Efm
Gg^Efm, Gs^Fds, Gs^Fds, Gg^Efm, Gs^Fds, Gs, Gg, Cer^Edb, Gg^Efm, Gg^Es, Gs^Fds, Gs^Fds, Hh, Hh, Mm, Gs^Fds, Hh^Es, Gll^Em, Gg^Efm, Gs^Fds, Gg^Efm, Gg^Efm, Gs^Fds, Gs^Fds, Gg, Gs^Fds, Gs, Gg, Gg^Efm, Gs^Efm, Gs^Efm, Gg^Es, Gg, Gg^Efm, Gg^Ve, Hh, Mm, Wwf, Wwr, Wwr, Mm, Wo, Wo, Ww^Ewf, Wwf, Mm, Gs^Fds, Gs^Efm, Gs, Gll, Gs^Fms, Gs^Fds
Gs^Fds, Gs^Fds, Gs^Fds, Gs^Fds, Gs, Gs^Efm, Gg^Edb, Gs^Edb, Gg^Edb, Gs^Efm, Hh, Mm, Mm, Gg^Fet, Gs^Efm, Mm, Mm, Cv, Gs, Gs^Efm, Gg^Ve, Gg, Gs^Efm, Gs, Gs^Efm, Gg^Efm, Gs^Efm, Gg, Gs^Fds, Gg, Gg^Efm, Gs^Fds, Gg^Efm, Gg^Efm, Hh, Mm, Mm, Ww^Ewl, Mm, Ww, Wo, Wo, Wo, Mm, Wwf^Es, Mm, Hh, Hh, Gg, Gll^Fp, Gll^Fp, Gs^Fms
Gs, Gs^Efm, Gs^Fds, Gs^Fds, Gg^Efm, Gs^Es, Gg^Efm, Gg^Edb, Gs^Efm, Hh, Mm, Mm, Ww^Ewf, Wwf, Wwf^Es, Wwr, Mm, Mm, Gg, Gg, Gs, Gs^Efm, Gs^Fds, Gg, Gs^Efm, Gs, Gll^Em, Gs, Gll^Fp, Gs^Fds, Gs^Efm, Gs^Fds, Gs^Fds, Hh, Gg^Efm, Mm, Hh, Mm, Mm, Ww^Ewl, Ww, Gg^Fet, Wwr, Ww, Gs^Fds, Gs^Fds, Gs^Fds, Hh, Gg^Efm, Gll, Gs^Fds, Gs^Fms
Gs^Fds, Gs^Fds, Gs^Fds, Gs^Efm, Gg^Efm, Gs^Efm, Gs^Fds, Gs, Gg^Efm, Gs, Gs^Fds, Mm, Ww, Wo, Wwr, Gs^Es, Gs^Efm, Hh, Gs^Efm, Gs^Fds, Gg, Gs^Fds, Gs^Fds, Gs, Gs^Fms, Gll^Fp, Hh, Gll^Fp, Gs^Fds, Gs^Fms, Gg^Efm, Gs^Fds, Gs^Fds, Gs^Fds, Gll, Gll^Fp, Gll^Fp, Gll^Fp, Mm, Mm, Wwf^Es, Wwr, Wwr, Mm, Mm, Gs^Fds, Gs^Fds, Hh, Gg^Efm, Gg, Gs, Gg
Cv, Gs^Fds, Gs^Fds, Gs, Gg, Gg, Gll, Gg, Gs^Fds, Hh, Gs^Fds, Hh^Es, Mm, Wwf^Es, Mm, Mm, Hh, Gg, Gll, Gg^Efm, Gs^Fds, Gg^Es, Gg^Efm, Gs, Hh, Gll^Fp, Hh^Es, Mm, Mm, Hh, Mm, Gs^Fds, Mm, Gs, Gs^Fms, Gll^Fp, Hh, Gs^Fms, Gs^Fds, Mm, Mm, Hh, Wwf, Ww, Wo, Hh, Gs^Fds, Gs^Fds, Gg, Gs^Efm, Gs, Gg^Efm
Gg, Cv, Gg^Efm, Gs, Gs^Fds, Gs^Fds, Gll^Fp, Gs^Fds, Gs^Fds, Gs, Gs^Efm, Gs^Fds, Hh, Mm, Hh, Mm, Gg, Gll^Fp, Gll^Fp, Gll^Fp, Gs^Efm, Gs^Efm, Gs, Gg, Hh, Gll^Fp, Mm, Mm, Wwf^Es, Wwf, Wwf, Mm, Mm, Hh, Gg^Efm, Gll^Fp, Hh, Hh^Es, Gs^Fds, Mm, Gs^Efm, Mm, Hh, Gs^Fds, Ww, Hh, Gs, Gs^Fds, Gg^Efm, Gg^Es, Gg^Efm, Gg^Efm
Gll, Gs^Efm, Gll^Fp, Gg, Gs^Fds, Gs^Fms, Gs^Fds, Gs^Fms, Gll^Fp, Gs^Fds, Gs^Fds, Gg^Efm, Hh, Mm, Sm, Ss, Hh, Gs^Fds, Gs^Fds, Gs^Fms, Gg, Gg^Efm, Gll^Fp, Hh, Gll^Fp, Mm, Mm, Mm, Wwf^Es, Ww^Ewl, Wo, Wwf^Es, Wwr, Mm, Ww, Hh, Ww^Ewl, Gs^Efm, Gs, Gg^Ve, Gg, Hh, Wwf^Es, Ww^Ewf, Cme, Gs^Efm, Gg, Gs^Efm, Gg, Gs^Fds, Gs^Fms, Gs^Fds
Gs, Gll^Fp, Gll^Fp, Gg^Efm, Gg, Gll^Fp, Gll^Fp, Gs^Fms, Gg^Efm, Gg^Es, Gs, Gs^Fds, Gs^Fds, Hh, Wwf, Sm, Wwf^Es, Gg^Efm, Gg, Gg^Efm, Gg^Efm, Gll^Fp, Hh, Hh, Hh, Mm, Mm, Wwf^Es, Ww, Wo, Wo, Wwr, Wwr, Mm, Mm, Wo, Wo, Gg^Efm, Gs^Efm, Hh, Gll, Hh, Wwf^Es, Wwr, Wwr, Gg^Efm, Gg, Gs^Fds, Gs^Fds, Gs^Fds, Gll^Fp, Gs^Fds
Gs^Fms, Gll^Fp, Gll^Fp, Gll^Fp, Gs^Efm, Gll, Gs^Efm, Gs, Gs, Gs^Efm, Gg^Ve, Gs, Gs^Fds, Gs^Fds, Gg, Wwr, Wwf, Gs^Efm, Cme, Gs, Gg^Efm, Gs, Hh, Gll^Em, Mm, Mm, Hh, Ww^Ewl, Wwr, Mm, Ww, Ww, Mm, Wwf, Mm, Gll^Fp, Ww, Ww, Gll^Fp, Gll^Fp, Gll^Fp, Gs^Efm, Gs, Ww, Hh, Gs^Efm, Gg^Efm, Gs^Fds, Gs^Fms, Gll^Fp, Gll^Fp, Gll^Fp
Gs^Fms, Gs^Fms, Gll^Fp, Gll^Em, Gs, Gg^Efm, Gg, Gs^Efm, Gs^Fds, Gg, Gs^Fds, Gg, Gs^Fds, Gg^Efm, Gg^Efm, Wwf^Es, Gs, Ww, Wwf^Es, Wwr, Wwr, Gll^Fp, Gg^Ve, Gll^Fp, Hh, Mm, Wwf, Gs^Fds, Ww, Mm, Mm, Wwf^Es, Mm, Mm, Hh^Es, Hh, Gs^Efm, Wwr, Cme, Gll^Fp, Wo, Wo, Ww, Ww, Gg, Gs, Gg^Efm, Gs^Fds, Gs^Fds, Gll^Em, Gs^Efm, Gll^Fp
Gs, Gs^Fms, Gg, Gs^Efm, Gg, Gg^Es, Gg, Gs^Fds, Gs^Fds, Gs^Fds, Gg, Gs^Efm, Gs, Gs^Efm, Gs^Fds, Gg^Efm, Gs^Fds, Gg^Efm, Gs^Fds, Gs^Efm, Wwf, Gg^Efm, Gll^Fp, Gll^Fp, Hh, Mm, Hh, Wo, Ww, Mm, Gs^Fds, Gs^Fds, Gg^Efm, Hh, Gs^Efm, Hh, Gs^Fds, Ww, Wwf, Ww^Es, Hh, Gg^Efm, Gg^Efm, Gs^Efm, Gg^Es, Gs^Efm, Gg, Gs, Hh, Gg, Gll^Fp, Gs
Gs^Efm, Gs^Efm, Gg, Gs^Fds, Gs^Fds, Gs^Fds, Gg^Efm, Gs^Fds, Gg, Gs^Fds, Gg, Gs^Efm, Gg, Gg^Efm, Gs^Fds, Gs^Fds, Gs^Efm, Gs^Fds, Gs^Fds, Gs^Fds, Hh, Mm, Hh, Gs, Wwr, Ww, Ww^Es, Wo, Wwf, Gs^Fds, Cv, Cv, Kv, Cv, Cv, Gs^Fds, Gs^Fds, Gg^Efm, Wwf^Es, Wwf, Gg, Gg^Fet, Gs^Fds, Gs^Efm, Gll^Fp, Gs^Fms, Gll^Fp, Hh, Gll^Es, Hh, Hh, Gll^Fp
Gg, Gs^Efm, Gs^Fds, Gs^Fds, Gs^Fds, Gs^Fds, Gs^Fds, Gs^Efm, Gs, Gg^Efm, Gs^Efm, Gs^Efm, Gg, Gs^Fds, Gs^Fds, Gs^Fds, Gg^Efm, Gs^Fds, Gg^Efm, Gs^Fds, Gs^Efm, Hh, Wwf, Ww^Es, Cme, Gs^Efm, Gs^Efm, Wwf, Hh, Hh, Gg^Efm, Gg^Efm, Gs, Hh, Gs^Efm, Gg, Hh, Wo, Gg^Efm, Gs^Efm, Gs^Fds, Gs^Fds, Gs^Fds, Gll, Gll^Fp, Gll^Fp, Gll^Fp, Gll^Fp, Hh, Gll^Fp, Gll^Fp, Gll^Fp
Gg, Gg^Efm, Gg^Es, Gg, Gg, Gs^Fds, Gg, Gs^Fds, Gs^Efm, Gg, Gs, Gg, Gg^Efm, Gg, Gs^Fds, Gs^Fds, Gs^Fds, Gs^Es, Gs^Efm, Gs^Efm, Gg, Gg^Efm, Hh, Wwr, Gs^Fds, Gs, Gg^Efm, Gs^Fds, Gs^Fds, Hh, Gs^Fds, Gs^Fds, Gs^Fds, Gg^Efm, Gg^Ve, Gs^Efm, Gg, Ww, Wwr, Gs^Efm, Gs^Fds, Gs^Fms, Gll^Fp, Gs^Fds, Gll^Fp, Hh, Mm, Gll^Fp, Hh, Hh^Es, Mm, Gll^Fp
Gs, Gs^Efm, Gg^Efm, Gg^Fet, Gg, Gg^Efm, Gg^Efm, Gg^Es, Gg, Gs^Efm, Gg, Gs^Fds, Gg^Efm, Gs^Efm, Gg, Gg, Gg^Efm, Gg^Efm, Gs, Gs, Hh^Es, Hh^Es, Gg^Efm, Ww, Gg, Hh, Hh, Gg^Ve, Gs^Fds, Gg^Fet, Gg^Efm, Gs^Efm, Gs^Fds, Gs^Fds, Gs, Mm, Mm, Cme, Wwf, Hh, Mm, Gs^Fds, Gll^Fp, Mm, Mm, Hh, Mm, Mm, Mm, Mm, Mm, Hh
Gs^Fds, Gg, Gs^Fds, Gg^Efm, Gg, Gs^Efm, Gs, Gs, Gs^Fds, Gs^Fds, Gs^Efm, Gs^Fds, Gs^Fds, Gg^Ve, Gg, Gs^Efm, Gs^Fds, Gs^Fds, Gs^Fds, Gs^Fds, Gg, Hh, Wwr, Wwf^Es, Hh, Hh, Gll^Fp, Gll^Fp, Gg^Efm, Gs^Es, Gs^Fds, Hh, Hh, Hh, Mm, Hh, Mm, Wwr, Mm, Mm, Mm, Hh, Gs^Efm, Mm, Mm, Mm, Gll^Fp, Mm, Hh^Es, Mm, Mm, Mm
Gs^Fds, Gs^Fds, Gs^Fds, Gg, Gs, Gg^Efm, Gg, Gg, Gll^Em, Gs^Fds, Gs^Efm, Gg^Efm, Gs, Gg, Gg^Efm, Gs^Fds, Gs, Gs^Fds, Gs^Fds, Gs^Fds, Gs^Efm, Hh, Wwf, Wwf, Gs^Efm, Gll^Fp, Gll, Gll, Gs^Fds, Gs, Gs^Fds, Gs^Fds, Gg^Efm, Mm, Mm, Gs^Efm, Ww, Ww, Hh^Es, Mm, Mm, Mm, Gs^Fms, Mm, Gll^Fp, Hh, Hh, Hh, Gll^Fp, Mm, Hh, Mm
Gs^Efm, Gs^Fds, Gs^Fds, Gs^Fds, Gg^Efm, Gs, Gg, Cv, Gll^Fp, Gll^Fp, Wwf^Es, Gg^Efm, Wwr, Cv, Gg, Gs^Efm, Gs^Efm, Gg^Efm, Gs^Efm, Gg, Gg^Efm, Gs^Efm, Ww, Wo, Gs, Gs^Efm, Gs^Fds, Gs^Fds, Gs^Efm, Gs^Fds, Gg^Ve, Gs^Fds, Hh, Hh^Es, Mm, Mm, Wwf, Wo, Wo, Mm, Mm, Mm, Gll^Fp, Gll^Fp, Gg^Ve, Hh, Gll, Gll^Fp, Gs^Fds, Gll^Fp, Gll^Fp, Hh
Gs^Fds, Gs^Efm, Gg, Gs^Fds, Gg, Gs^Efm, Gs^Fds, Gg, Ww^Ewl, Wwr, Ww^Ewf, Ww, Wwf, Gs^Fds, Gs^Fds, Gg^Fet, Gs, Gg, Gs^Efm, Gs^Efm, Gg, Gs^Efm, Wwf, Ww^Es, Wwf, Gg^Efm, Gll^Fp, Gs^Fds, Gs, Gs^Fds, Gg^Efm, Gs, Mm, Mm, Mm, Wwr, Wo, Gs^Fds, Wwf^Es, Ww^Ewf, Gs^Fds, Gs^Fms, Gs^Fds, Gs^Efm, Gs, Gg, Gg^Efm, Gll^Fp, Gs^Fds, 1 Gll^Fp, Gll^Fp, Gll^Fp
Gs, Gg^Es, Gs, Gs^Fds, Gg, Gs^Fds, Gs^Fds, Gs^Fds, Gg^Efm, Wwf^Es, Wwf^Es, Ww, Ww^Ewl, Wwr, Gg^Efm, Gs^Fds, Gs^Fds, Gs^Fds, Gs^Fds, Gs^Fds, Gs^Fds, Cme, Wwr, Wwr, Hh, Hh, Gll^Fp, Gll, Gg^Efm, Gg^Efm, Gs^Efm, Hh, Hh^Es, Mm, Wwf, Ww^Ewf, Wwr, Wwr, Mm, Mm, Gs^Fds, Gs^Fds, Gs^Fds, Gs^Fds, Gs^Fds, Gs^Fds, Gs^Efm, Gs, Gs^Fds, Gs^Fms, Gll^Fp, Gs
Gs^Efm, Gs^Efm, Gg, Gg, Gll^Fp, Gll^Fp, Gs^Fds, Gs^Fds, Cv, Gs, Gs^Efm, Gll^Fp, Cv, Gg^Efm, Gs, Gs^Fds, Gs, Gg^Efm, Gs^Fms, Gs^Fds, Hh, Wwf, Ww, Gs, Gs^Efm, Gll^Fp, Gll^Fp, Gs, Gs^Fds, Gs^Fds, Gs^Fds, Gs^Fds, Gs^Fds, Gs^Fds, Mm, Wwf^Es, Mm, Wwr, Mm, Mm, Hh, Gs^Efm, Gs, Gg, Gs^Efm, Gs, Gg, Gg^Efm, Gg, Gll, Gll^Fp, Gll^Fp
Gg, Gg^Efm, Gs^Efm, Gs^Fds, Gll^Em, Gll^Fp, Gll^Fp, Gg, Gg^Efm, Gs, Gs^Fds, Gg^Efm, Gg, Gs^Fds, Gs^Fds, Gg^Efm, Hh, Hh, Gs^Fms, Gg, Ww^Ewl, Wwf^Es, Wo, Gs^Efm, Gs^Fds, Gll^Em, Gs^Fds, Gs^Fds, Gs^Fds, Gs^Efm, Gs^Fds, Gs^Fds, Gs^Efm, Gs^Fds, Gs^Efm, Mm, Mm, Gs^Efm, Hh, Mm, Gs^Efm, Gg^Es, Gs, Gg^Efm, Gg, Gs^Efm, Gg, Gs^Fds, Gs^Fds, Gg^Efm, Gg, Gll
Gs, Gs^Efm, Gg^Efm, Gs^Efm, Gs^Efm, Gll^Fp, Gg^Es, Gg^Ve, Gs^Efm, Gs^Fds, Gs^Fds, Gs^Fds, Gs^Fds, Gs^Fds, Gs^Fds, Gg^Efm, Hh, Gll^Es, Gll^Fp, Gll^Fp, Ww, Wo, Hh, Hh, Gs^Fds, Gs^Fds, Gs^Fds, Gs, Gs^Fds, Gs^Efm, Gg^Es, Gs^Fds, Gg, Gs^Fds, Hh, Hh, Gll^Fp, Gs, Gs, Gg^Efm, Hh, Hh, Gs, Gg^Efm, Gs^Efm, Gg, Gll^Fp, Gll^Em, 2 Gs^Fms, Gs^Fms, Gs, Gg^Efm
Gg, Gs, Gs^Fds, Gg, Gg^Efm, Gg^Efm, Gg, Gs, Gs, Gg, Gs^Efm, Gs, Gs^Efm, Gs^Fds, Gs^Fds, Gs, Gg, Gs, Gs, Gll^Em, Ww, Gs^Fds, Gs^Fds, Gg^Efm, Gs^Fds, Gg^Efm, Gs^Efm, Gs^Fds, Gg, Gs^Fds, Gg^Efm, Gs, Gs^Efm, Gs, Gs, Gg^Ve, Gll, Gll^Fp, Gll^Em, Gg, Gs, Gs, Gs^Efm, Gg^Efm, Gs^Efm, Gs, Gll, Gll^Fp, Gll^Fp, Gs^Fds, Gs^Efm, Gs^Efm
Gg, Gs^Fds, Gs^Efm, Gg, Gs^Fds, Gs, Gs^Fds, Gg^Efm, Gs^Efm, Gs^Efm, Gs, Gg^Es, Gs^Fds, Gg^Efm, Gs, Gs^Fds, Gs^Efm, Hh, Wwf, Wwr, Cme, Wwf, Gs, Gs, Gs^Fds, Gs^Fds, Gg, Gg^Fet, Gs^Efm, Gs^Efm, Gg^Efm, Gs, Gg^Efm, Gs^Efm, Gs, Gs, Gll^Fp, Gs^Fds, Gll^Fp, Gs^Efm, Gs^Efm, Gs, Gs, Gg, Gg^Fet, Gg^Es, Gg, Gs^Fds, Gs^Efm, Gs, Gs^Efm, Gs^Efm
Gs^Fds, Gs^Fds, Gs^Fds, Gg^Efm, Gs^Fms, Gll, Gll^Fp, Gg, Gg^Efm, Gs^Efm, Gg, Gg^Efm, Gg, Gs^Fds, Gs^Efm, Gs, Gg^Efm, Hh, Gg^Efm, Ww, Wwr, Gg^Efm, Gs^Efm, Gs^Fds, Gs^Fds, Gg^Efm, Gg^Ve, Gs^Efm, Gg^Efm, Gs^Fds, Gs^Fds, Gs, Gs^Efm, Gg^Efm, Gg, Gll^Em, Gs^Fms, Gll^Fp, Gs^Fds, Gs, Gg^Efm, Gg^Efm, Gs, Gs, Gg^Efm, Gs, Gg^Efm, Gg^Efm, Gs, Gg, Gg^Efm, Gg
Gs, Gs^Fds, Gs^Fds, Gs^Fds, Gll^Fp, Gll^Fp, Gs, Gs^Fds, Gs^Fds, Gg, Gll^Em, Gll^Fp, Gll^Fp, Gs^Efm, Gg^Efm, Gs, Hh^Es, Gg, Ww^Ewf, Gs^Efm, Wo, Gs^Efm, Gs^Fds, Gs^Fds, Gg, Gg, Gs, Gg^Efm, Gs^Fds, Gs^Fds, Gs^Fds, Gs^Fds, Wwf, Gs, Gs, Gs^Fds, Gg, Gs^Fds, Gs, Gs^Efm, Gs^Es, Gs^Fds, Gs^Fds, Gs^Fds, Gs^Fds, Gs, Gs^Efm, Gg, Gs^Fds, Gs^Fds, Gs^Fms, Gg^Efm
Gg^Efm, Gs^Efm, Gg, Gs, Gs, Gll, Gs^Efm, Gs^Efm, Gs^Fds, Gg^Efm, Gll^Fp, Gll^Fp, Gs^Fms, Gs^Fds, Gs^Efm, Hh, Gg, Gs^Efm, Ww^Es, Wo, Gg, Wwf, Gg^Efm, Gs^Fds, Gs^Efm, Gs^Efm, Gg, Gs^Fds, Gs^Fds, Gs^Fds, Gs^Fds, Gs^Fds, Ww^Ewf, Wwf, Gg^Es, Gg^Efm, Gs^Efm, Gg^Efm, Gs^Efm, Gs, Gs, Gs, Gs^Fds, Gg, Gs^Fds, Gs^Efm, Gg^Efm, Gs, Gs^Fds, Gll^Fp, Gll^Fp, Gll^Fp
Gs, Gs^Fds, Gs^Fds, Gs^Efm, Gg^Efm, Gg^Fet, Gs, Gg, Gs^Efm, Gg, Gg^Efm, Gll^Fp, Gg, Gs, Gg^Efm, Gs, Cme, Ww^Es, Wwf, Gs^Efm, Gs, Gs^Efm, Gs, Gs^Fds, Gg, Gs^Efm, Gs^Efm, Gs^Efm, Gs, Gg, Gs^Fds, Gs^Fds, Gs^Efm, Gs^Efm, Gg, Gg^Efm, Gs^Efm, Gs, Gs^Fds, Gs^Fds, Gs^Efm, Gg^Efm, Gs^Efm, Gs, Gs, Gg, Gs, Gg, Gs^Fms, Gll, Gs^Fms, Gll^Fp
Gs^Fds, Gll, Gs^Fms, Gs^Efm, Gs^Fds, Gs^Es, Gs, Gs^Efm, Gs, Gg^Efm, Gs^Efm, Gs, Gs^Efm, Gg^Efm, Gs^Efm, Gg^Efm, Gs^Fds, Wwr, Wwr, Gg^Efm, Gs^Efm, Gs, Gs^Es, Gg, Gs^Fds, Gs^Fds, Gs^Fds, Gs, Gs^Fds, Gg^Efm, Gg^Efm, Gg, Gs, Gg^Efm, Gg, Gs, Gs, Gs, Gs^Fds, Gs^Fds, Gg, Gs^Efm, Gg, Gs^Efm, Gs^Fds, Gs^Efm, Gg^Efm, Gg^Efm, Gg, Gll^Fp, Gs^Fds, Gll^Fp
Gs^Fds, Gll^Fp, Gll^Fp, Gs^Fds, Gg^Efm, Gs^Fds, Gg^Efm, Gg^Efm, Gs^Fds, Gg, Gs^Fds, Gg, Gs^Fds, Gg^Efm, Gs, Gg^Es, Gs^Fds, Gs, Ww, Gg^Efm, Gg^Efm, Gg^Efm, Gs^Fds, Gs, Gs^Fds, Gs^Fds, Gs^Fds, Gg^Es, Gs^Fds, Gs, Gs^Efm, Gs^Efm, Gg, Gs^Fms, Gll^Fp, Gll, Gs^Fds, Gs^Es, Gg, Gs^Fds, Gg^Efm, Gs^Fds, Gs^Fds, Gs^Fds, Gs^Fds, Gg, Gg^Efm, Gs^Efm, Gs, Gll^Em, Gs^Fds, Gg
Gs^Fms, Gll^Fp, Gll^Fp, Gs^Fds, Gs^Efm, Gs^Fds, Gs^Fds, Gs^Efm, Gs^Fds, Gs^Fds, Gs^Fds, Gs^Fds, Gs^Fds, Gs^Fds, Gs^Fds, Gs^Fds, Gg, Gs^Fds, Gs^Fds, Wo, Gg, Gs^Fds, Gs^Fds, Gs^Fds, Gs^Fds, Gs^Fds, Gs^Fds, Gs^Fds, Gs^Fds, Gs^Efm, Gg, Gs^Efm, Gs^Fds, Gll^Fp, Gll^Fp, Gll^Fp, Gll^Fp, Gg^Efm, Gg^Efm, Gs^Efm, Gs^Efm, Gg, Gg, Gg, Gg, Gs^Fds, Gg^Efm, Gs^Efm, Gs^Fds, Gs^Fds, Gs^Fds, Gg
