Hh^Es, Gs^Es, Hh^Es, Gs, Gll^Fp, Gg, Gg^Efm, Gg, Hh, Hh, Gs^Fds, Hh, Gs^Fds, Gg^Efm, Gs^Em, Gs^Fms, Gll^Fp, Gll^Fp, Wwf, Gg^Efm, Gs^Fds, Gs^Fds, Gs^Fds, Gs^Fms, Gg^Efm, Gs^Fds, Gs^Fds, Gg, Gs^Efm, Gg, Gs^Fds, Gg
Hh, Gs^Fds, Gll, Gs^Efm, Hh^Es, Hh^Es, Gs^Efm, Gs^Fds, Hh^Es, Gs^Efm, Hh, Hh, Gs^Fds, Gs^Fds, Gs^Fds, Gs^Fms, Gs^Fds, Gs^Fms, Gs^Fds, Ww, Gs, Gs^Fds, Gs^Fds, Gs^Fms, Gg, Gs, Gs^Fds, Gs^Efm, Gs, Gg^Fet, Gs^Fms, Gll^Fp
Gs^Fds, Hh^Es, Gll^Fp, Gs^Fds, Hh, Gs^Efm, Gg^Fet, Hh, Gs^Fds, Gs^Em, Gll^Fp, Gll, Hh^Es, Gs^Fds, Gg^Efm, Gs^Efm, Gll^Fp, Gs^Fds, Hh, Wwf, Ww, Gs^Fds, Gs^Efm, Gs, Gg^Efm, Hh, Hh^Es, Gs^Fds, Gg^Efm, Gs, Ww, Gll^Fp
Hh, Hh, Gll^Em, Gs^Fms, Gs^Fds, Gs^Fds, Gll, Hh, Gll, Gs^Fds, Gs^Fms, Hh, Hh^Es, Gs^Fds, Gs^Fds, Gs, Gll, Hh^Es, Gg, Ss, Sm, Wwf, Wwf^Es, Wwf, Ww, Hh, Gg^Efm, Gs^Em, Wwf, Wwf^Es, Gs^Efm, Ww
Hh, Gs^Fds, Gs^Efm, Hh, Gll^Fp, Gll^Fp, Hh, Gs^Efm, Hh, Gll^Fp, Gll^Fp, Hh, Gs^Fds, Gs, Gg^Es, Gg, Gs, Hh^Es, Gs^Fds, Gs^Fds, Gs^Fds, Gs, Gll^Em, Gll, Gll^Fp, Ww, Ww, Wwf, Sm, Gs^Fds, Gs^Fds, Gs^Efm
Gs^Fds, Gs^Fds, Hh, Gll, Gll^Fp, Hh, Hh, Gg^Efm, Hh^Es, Gll^Fp, Hh, Gs^Fms, Gs^Fds, Gs^Efm, Gs^Efm, Gg, Gg^Efm, Gs^Efm, Gs^Fds, Gs^Fds, Gs^Efm, Gg^Efm, Gll^Fp, Gll^Fp, Gs^Fms, Gg^Efm, Gg^Efm, Gs, Hh, Gs^Fds, Gs, Gs^Fds
Gs^Efm, Gs^Es, Hh^Es, Hh, Gs, Gs^Fds, Hh^Es, Gs^Fds, Gs^Fds, Hh^Es, Gg^Efm, Gg, Gg, Gg^Efm, Gg, Gg, Gg^Es, Gs^Fds, Gll^Em, Gll^Fp, Gs, Gg^Efm, Gs, Gs^Fms, Gll, Gll^Fp, Gs, Gs, Gs^Es, Hh^Es, Gll, Gs^Fds
Gs^Fds, Gs^Efm, Gs^Fds, Hh, Gll^Fp, Gll, Gs^Efm, Hh, Gs^Fds, Gg^Efm, Hh, Gs^Fds, Gll^Fp, Gg, Gs, Gll, Gll^Fp, Gs^Fms, Gll^Fp, Gs^Fms, Gll, Gs^Efm, Gs^Fds, Gs^Efm, Gg^Es, Gs^Fds, Gs^Fds, Gg, Gs, Gg^Efm, Gs^Fms, Gll^Fp
Hh, Hh, Gs^Es, Gs^Fds, Hh^Es, Gll^Fp, Gs, Gg^Efm, Gs, Gg, Gs^Fds, Gs^Fms, Gll^Fp, Gll, Gg^Efm, Gll^Fp, Gs, Gs, Gll^Fp, Gll^Fp, Gg, Gg, Gs^Fds, Gs, Gs, Gs^Efm, Gs^Fds, Gs^Fds, Gs^Fds, Gs, Gs^Fms, Gs^Fds
Hh, Gll, Hh, Hh, Hh, Gs, Gs^Fds, Hh, Hh^Es, Gs^Efm, Gs, Gll, Hh^Es, Hh^Es, Gs^Efm, Gll, Gg, Gs, Hh, Gll, Gs, Gs^Fds, Gg, Gs^Fds, Gs, Gs^Fds, Gs^Fms, Gll^Fp, Gs^Fds, Gs, Hh, Gll^Fp
Gll^Fp, Gll^Fp, Gll^Em, Gs^Fds, Hh^Es, Gs^Efm, Gg^Efm, Gs^Fds, Gs^Fms, Gg^Efm, Gg, Gg^Es, Gs, Gg, Gs^Efm, Gg^Efm, Gs^Fds, Gs^Es, Gs, Hh, Gs, Gg^Efm, Gg^Fet, Gg^Efm, Gs, Gs^Efm, Gg^Es, Gs^Fds, Gs^Efm, Gs, Gg, Hh^Es
Hh, Gll^Fp, Gs^Fds, Hh, Gs^Efm, Gs^Es, Gs^Fds, Hh^Es, Gs^Fms, Gs^Fds, Gg^Efm, Gs^Efm, Gll, Gll, Gs^Fds, Gg, Gs^Fds, 2 Gs^Fds, Gg^Efm, Gs^Efm, Gs, Gg^Efm, Gg^Es, Gg, Gs^Efm, Gs, Gs^Efm, Gg, Gs^Efm, Gs^Efm, Gs^Fds, Gg^Efm
Hh, Gs^Fms, Gs^Efm, Gs, Gs^Fds, Hh, Gll^Fp, Hh, Gs, Gs^Fds, Hh, Gg, Gll, Gll^Fp, 1 Gs^Fms, Gs^Fds, Gll, Gs, Gg^Efm, Gs^Es, Gs^Efm, Gs, Gs^Efm, Gs, Gs, Gs, Gg, Hh, Hh, Gs^Efm, Gs^Fds, Hh
Hh^Es, Hh, Gs^Efm, Hh, Gs^Fds, Hh, Hh, Gg, Gs^Efm, Hh, Gs^Fds, Gg^Em, Gg^Efm, Gll^Fp, Gs^Fds, Gll^Fp, Gll^Fp, Gs^Fds, Gs^Fds, Gs^Fds, Gs^Fds, Gs^Efm, Gs, Gs^Efm, Gs^Fds, Gg^Efm, Gs, Gs, Hh^Es, Gs, Gll, Gs^Fds
Hh, Gs^Fds, Gs, Hh^Es, Gll, Gs, Hh, Gg^Fet, Gs^Efm, Gg^Efm, Hh, Gs^Fds, Gs, Gll, Gs^Efm, Gs^Fms, Gll, Gg^Efm, Gs, Gs^Efm, Gs^Efm, Gg^Efm, Gs, Gs^Efm, Gs^Fds, Gs, Gs^Efm, Gg^Efm, Gs, Gs^Fds, Gll^Fp, Gll^Fp
Gg^Efm, Gs^Fds, Gs^Fms, Gs^Fds, Gs^Fms, Gs^Fds, Gll, Gs^Es, Hh, Gg, Gs^Fds, Gs^Efm, Gg, Gs, Gg, Gg^Efm, Gs^Es, Gg^Efm, Gs^Fds, Gs^Fds, Gs^Em, Gg^Es, Gg^Efm, Gs^Fds, Hh, Gs^Fds, Gs^Fds, Gg^Efm, Gll, Gs^Fds, Gs^Fms, Gs^Fds
Gs^Fds, Gs^Fds, Hh^Es, Gll^Fp, Gll^Em, Gll^Fp, Gg, Gs^Fds, Hh^Es, Hh^Es, Gs^Fms, Gs^Fds, Gs^Efm, Gs^Efm, Gs, Gs^Fds, Gs^Fds, Gs, Gs^Fds, Gs^Fds, Gs^Fds, Gs^Efm, Gg, Gg, Gg, Hh^Es, Gs, Gs, Gs^Fms, Gll^Fp, Gs^Fms, Gll^Em
Gs^Fds, Hh^Es, Gs^Fds, Gll, Gs, Hh, Hh^Es, Gs^Fds, Gs^Fds, Gs^Fms, Hh, Gg, Hh^Es, Hh^Es, Gg, Gg, Gs^Fds, Gs^Fds, Gs^Fds, Gs^Efm, Gs, Gs^Efm, Gs^Fds, Gs^Efm, Gs^Efm, Gs^Efm, Gg^Efm, Gs^Fds, Gs^Fds, Gll^Fp, Gll, Gll^Fp
Gs^Efm, Hh, Gs^Fds, Gs^Efm, Gg^Efm, Hh^Es, Gs^Fds, Gll^Em, Gll^Fp, Gll^Fp, Gll, Gg^Efm, Hh, Gs^Efm, Gs, Gs^Fds, Gs, Gs, Gs^Efm, Gg, Gs^Fds, Gg, Gs^Fds, Gs^Fds, Gs^Fds, Gg^Efm, Gg^Es, Gg, Gg^Efm, Gs^Fds, Gs^Efm, Gg^Efm
Gs^Efm, Gs^Fds, Gs^Efm, Gg, Hh, Hh, Hh^Es, Hh, Gs^Es, Gs^Fms, Gs, Gg, Gg^Efm, Gs, Gll, Gg, Gg^Efm, Hh, Hh^Es, Gg^Fet, Gs^Fds, Gs^Fds, Gs^Efm, Gs^Fds, Gg^Efm, Gs, Gs^Fds, Hh, Hh, Gg, Gs^Fds, Gs^Fds
Hh, Hh^Es, Gs^Fms, Gs^Efm, Gs^Fds, Gs^Fds, Gg^Efm, Hh^Es, Gll, Gll^Fp, Gll^Fp, Gs, Gs^Fms, Gll^Fp, Gs^Fms, Gll^Fp, Gll, Hh^Es, Gg, Gs^Efm, Gg, Gg, Gs^Es, Gs^Fds, Gs, Gs^Efm, Hh^Es, Hh^Es, Gll, Gs^Fds, Gll^Fp, Gs^Fds
Gs^Fds, Gs^Fds, Gll^Fp, Gll^Fp, Hh, Hh, Gs^Fds, Gs^Fds, Gg, Gll^Fp, Gs^Fds, Gll^Efm, Gg, Gll^Fp, Gll^Fp, Gll^Fp, Gll^Fp, Gs, Hh, Gs^Efm, Gg^Efm, Gg^Efm, Gs, Gg, Gg^Efm, Gs^Fds, Gs^Fds, Gg, Gll, Gll^Fp, Gll^Fp, Gll^Fp
