Wog, Wog, Wog, Wwg, Ww, Wwg, Wog, Wog, Wog, Wwg, Wwf, Mm, Mm, Mm, Mm, Mm, Hh^Es, Gs^Fms, Gs^Fms, Gll^Fp, Gll^Fp, Gs^Fds, Gs^Fds, Gs^Fds, Gs^Fds, Gg, Gll^Fp, Gll^Fp, Wwf^Es, Wo, Cme, Gs^Fds, Gs^Fds, Gs^Fds, Gs^Fms, Gll^Fp, Gll^Fp, Gg, Hh, Gs^Efm, Hh, Gs, Gs^Efm, Gg, Hh, Gg, Ww^Ewl, Ww, Wwr, Gs^Fds, Gll^Fp, Gll^Fp, Gll^Fp, Gs^Fds, Gg^Efm, Gll^Fp, Gll^Fp, Gll^Fp, Wwf^Es, Wwr, Wwr, Ww, Gs^Fds, Gs^Fds, Gs^Fms, Gll^Fp, Gs^Fms, Gs^Fds, Gs^Fds, Gs^Fds, Hh, Hh^Es, Gll^Fp, Cme, Ww, Hh, Gll^Fp
Wog, Wog, Wwg, Wwrg, Wwr, Wwg, Wwrg, Wog, Wwrg, Wwrg, Hh, Mm, Mm, Mm, Mm, Hh, Gg^Efm, Gll^Fp, Gs^Fms, Gll^Fp, Gll^Fp, Gs, Gll^Fp, Gs^Fds, Gs^Efm, Gs^Fds, Gs^Es, Gll^Fp, Gg^Efm, Ww, Wo, Wwf^Es, Wwf, Gll^Fp, Gll^Fp, Gll^Fp, Gll^Em, Hh, Gg^Efm, Hh, Gs^Efm, Hh, Gs^Fds, Gs^Fds, Hh, Gll^Fp, Gll^Fp, Wwf, Wo, Gs^Fds, Gg^Efm, Gll^Fp, Gs^Fms, Gll^Fp, Gs, Gs, Gs^Efm, Gs^Fms, Gs^Fds, Gll^Fp, Ww, Gs^Efm, Gll^Fp, Sm, Ss, Gll^Fp, Gs^Fds, Gg^Fet, Gg^Es, Gs^Efm, Gll^Em, Gll^Fp, Gs^Fms, Ww, Hh, Hh, Gs^Fds
Wwg, Wog, Wwrg, Wwf^Es, Hh, Wwf^Es, Mm, Wwrg, Mm, Wwf^Es, Gs^Efm, Mm, Gll^Fp, Hh, Gll^Fp, Gll^Fp, Gll^Fp, Gs^Fms, Hh, Gll^Fp, Gs^Fds, Gs^Fms, Gll^Em, Gs, Gs^Fms, Gs^Fms, Gs^Fds, Gg^Efm, Gg^Fet, Wwf, Gs^Efm, Wo, Gs^Efm, Gg^Efm, Gg, Gll^Fp, Hh, Gs^Fds, Gll^Fp, Gs^Fds, Gs, Gg^Efm, Gs^Es, Gs^Fds, Gs^Fds, Hh, Hh, Gs^Efm, Wo, Wwf, Gll^Fp, Gll^Fp, Gs^Efm, Gs^Fds, Gg^Efm, Gs^Fds, Gll^Fp, Gs^Fds, Gll^Fp, Gs^Fms, Wwf^Es, Gs^Fds, Wwf, Ww^Ewf, Gs^Fds, Gg^Efm, Gs, Gs^Fds, Gll^Fp, Hh, Gs^Efm, Ww^Ewl, Wwf, Wwr, Gs^Fds, Gll^Fp, Gll^Fp
Wwg, Wwg, Ww, Cme, Wwr, Mm, Mm, Mm^Xm, Mm^Xm, Mm, Mm, Gs^Fms, Hh, Gll^Fp, Gll^Em, Gll^Fp, Hh, Hh, Hh, Gs^Fds, Gg^Ve, Gs^Fds, Hh, Hh^Es, Gs^Fds, Gs^Fds, Gs^Fms, Gs, Gll^Fp, Gg, Gg^Efm, Ww, Ww, Ww^Vm, Wwf^Es, Gs^Efm, Hh, Gs, Gll^Fp, Gs^Fms, Gs^Fds, Gg^Efm, Gs, Gs^Fds, Gll^Fp, Gg^Es, Gs^Fms, Wwf, Wwr, Gs^Es, Gs^Fds, Gll^Fp, Gs^Fds, Gs^Efm, Gs^Fds, Gs^Fds, Gll^Fp, Ss, Sm, Wwr, Wwf, Wwr, Wo, Gs^Fds, Gs^Fds, Gs^Fds, Gll, Gs^Fms, Gll^Fp, Hh, Wwf, Wwr, Wwf^Es, Gll^Fp, Gs^Fds, Gs^Fms, Gs^Efm
Wog, Wwg, Wwrg, Wwr, Wwr, Mm, Mm^Xm, Mm^Xm, Mm, Mm^Xm, Mm, Gll^Fp, Hh, Gs^Efm, Gs^Fds, Gs, Gs^Fms, Gll^Fp, Gs^Fms, Gs^Efm, Gs^Fds, Gs^Fds, Mm, Mm, Hh, Gs^Fds, Gs^Fms, Gll^Fp, Gll^Em, Gs^Efm, Gll^Fp, Gg^Efm, Wwf, Wwr, Wwr, Gs^Efm, Gll^Fp, Gg^Efm, Gll^Fp, Gll^Fp, Gg^Efm, Gg^Fet, Gg, Gg^Ve, Gs^Fms, Gll^Fp, Gg, Gs^Fds, Gs^Efm, Wwr, Gs^Fds, Gs^Fds, Gs^Fms, Gs^Efm, Gg^Efm, Gs^Fms, Gg^Efm, Sm, Gs^Fds, Gs^Fds, Gs^Fds, Wwr, Ww, Cme, Gs^Fds, Sm, Ss, Gll^Fp, Gll^Fp, Gs^Fms, Ww, Wo, Hh, Gll^Fp, Gs^Efm, Hh, Gg^Efm
Wog, Wog, Wwg, Ww, Ww, Mm, Mm, Mm, Mm, Mm, Mm, Mm, Gs^Fds, Hh, Gs^Fds, Gs^Fds, Gs^Fds, Gg^Efm, Gs^Fds, Hh, Mm, Hh, Mm, Mm, Gs^Fds, Gg^Efm, Hh, Gll^Fp, Gll^Fp, Gll^Fp, Gs^Fms, Gs, Gs^Fds, Gs^Efm, Wo, Gll^Fp, Gs^Fms, Hh, Gs^Es, Gs, Gs^Fds, Gs, Gs, Gg^Efm, Gs, Gs^Fds, Gs^Fds, Hh, Gll^Fp, Ww, Wo, Gs^Fds, Wwr, Ww^Ewf, Gs^Efm, Gs^Efm, Gs^Efm, Gll^Fp, Gs^Fms, Gs^Fds, Gs^Es, Gs^Efm, Gs^Fds, Wwr, Wwf, Wwf^Es, Gll^Fp, Gll^Em, Hh^Es, Wwr, Wwr, Gs^Efm, Hh, Gs^Fds, Gs^Fds, Hh, Gg^Fet
Wwg, Wwg, Ww, Wwr, Mm, Mm, Wwf^Es, Hh, Gll^Fp, Hh^Es, Gll^Fp, Hh^Es, Gs^Fds, Gs^Fds, Gs^Fms, Gs^Fds, Hh, Gs^Efm, Hh^Es, Mm, Mm, Mm, Mm, Gs^Fds, Gs^Fds, Gs, Hh^Es, Gg^Efm, Gs^Fms, Gs^Fms, Gs^Fds, Gs^Fds, Gs^Fds, Gg, Cme, Wo, Gs, Hh, Hh, Gs^Fds, Gs^Fds, Gs^Fds, Hh^Es, Gs^Fds, Gs^Fds, Gs^Fds, Hh, Hh, Gll^Fp, Gg^Efm, Wwf^Es, Wo, Wwr, Wwf, Gs^Es, Gg^Fet, Gll^Fp, Gg, Gs^Es, Gs^Fds, Gg^Efm, Sm, Wwf^Es, Wwr, Wwr, Gs^Fds, Gll^Fp, Gs^Fms, Hh, Ww^Vm, Wwf^Es, Ww^Ewf, Gs^Fds, Gg^Efm, Gs^Es, Gs^Efm, Gll^Fp
Wog, Wwg, Wwg, Wwr, Wwg, Wwrg, Wog, Wwrg, Hhd^Es, Gll^Fp, Gs^Fms, Gs^Efm, Hh, Gs^Fms, Gs, Gg^Efm, Hh^Es, Mm, Mm, Mm, Mm, Mm, Mm, Hh, Mm, Gs^Fds, Gs^Fms, Hh, Gs^Fms, Gs, Gs^Fds, Gs^Fds, Gs^Fds, Gs, Wwf, Wo, Wwf^Es, Gg^Efm, Gll^Fp, Hh, Gs^Fds, Gg^Efm, Gs^Fds, Hh, Gg^Efm, Hh, Gll^Fp, Gll^Fp, Gg, Gs, Gll^Fp, Gs^Efm, Wo, Gs^Efm, Gll^Fp, Gs^Fds, Gs^Fds, Gs^Fds, Gll^Fp, Gll, Gs, Gs^Efm, Wwf^Es, Wo, Gg^Efm, Gs^Fds, Gs^Fms, Hh, Hh, Gs^Fds, Ww, Gs^Efm, Gll^Fp, Gs^Fds, Gs^Efm, Hh, Gs^Fds
Wog, Wog, Wwrg, Ww, Wwrg, Wog, Wog, Wwf^Es, Hhd^Ecf, Gd, Gd^Es, Gs^Fms, Hhd, Re, Gll^Fdw, Gll^Fdw, Gll^Fdw, Gs^Fds, Mm, Mm, Mm, Mm, Hh^Es, Mm, Hh^Vhh, Gs^Fds, Gg, Gg^Efm, Gg^Efm, Gs^Efm, Gg^Efm, Gg, Gg^Efm, Gs^Efm, Gs^Fds, Wwr, Wo, Gll^Fp, Gg^Efm, Gll^Fp, Gs, Gs^Fms, Gll^Fp, Gll^Fp, Gs^Fms, Gg^Efm, Gg^Es, Gll^Fp, Gg^Efm, Gll^Fp, Gll^Fp, Gg, Wwf, Ww, Gg^Efm, Gs^Fds, Gll^Em, Gs^Fms, Gll^Fp, Gll^Fp, Gll^Fp, Ww^Ewl, Gs, Wwr, Wwf^Es, Gs^Fds, Hh, Gs, Gs^Efm, Wo, Gs^Efm, Gll, Gll^Fp, Gs^Fms, Hh, Hh, Gs^Fds
Wog, Wog, Wwrg, Wwr, Kme^Es, Wwrg, Wwf^Es, Wwrg, Gd^Edb, Gll^Fdw, Hhd^Es, Gd, Gll^Edb, Re, Gll^Fdw, Gd^Edb, Hhd^Es, Gs^Fds, Gs^Fms, Hh, Gs^Fds, Mm, Hh, Gs^Fms, Gs^Efm, Gs^Fds, Gs^Fds, Gs, Gg^Efm, Gs^Es, Gg, Gll^Fp, Gll^Em, Gs, Gs^Fds, Wwf^Es, Wwf, Wo, Ww, Gs^Efm, Gs^Fms, Gll^Fp, Gll^Fp, Gll^Fp, Gs^Fms, Gs, Gg^Efm, Gs, Gg^Efm, Ss, Ss, Sm, Ww^Vm, Wo, Wo, Wwf, Gs, Gll^Fp, Gll^Fp, Gs^Fms, Gg^Efm, Gs^Efm, Gs^Fds, Gs^Fds, Gs^Fds, Ww, Gs^Fds, Gs^Fds, Ww, Wo, Hh^Es, Gs^Fds, Gs^Efm, Gll, Hh, Gs^Fds, Gs^Fds
Wwg, Wwg, Ww, Wwf, Wwr, Gd^Es, Re^Vct, Gll^Fdw, Gll^Fdw, Gll^Fdw, Re^Edb, Gll^Fdw, Gll^Fdw, Gd^Edb, Gd^Fetd, Re^Vct, Gll^Edb, Hhd, Hhd^Es, Gll^Fdw, Gs^Fds, Gs^Fds, Gs^Fms, Gs^Fds, Hh, Gs^Fds, Gs, Gs, Gll, Gll^Fp, Gs^Fms, Gll^Fp, Gs^Fms, Gll^Fp, Gg^Efm, Ww^Ewf, Gs^Fds, Gs^Fds, Ww, Gs^Efm, Wwr, Gg^Efm, Gll, Gs^Fms, Gll^Fp, Gs^Efm, Gs^Efm, Gs^Fds, Gs^Fds, Sm, Sm, Gg, Gs^Fds, Gs^Fms, Gg^Efm, Ww, Wwr, Gs^Efm, Ww^Ewl, Gll^Fp, Gll, Gg^Efm, Gs^Fds, Gs^Fms, Gs^Fds, Ww, Wwr, Wo, Ww, Gs^Fds, Gs, Hh, Gll^Fp, Gll^Fp, Hh, Gs^Efm, Gs^Fds
Wog, Wwg, Ww, Wwr, Gll, Re^Edb, Re^Edb, Gll^Fdw, Re, Re^Edb, Gll^Edb, Gll^Es, Gd^Edb, Re, Re^Edb, Re^Es, Gd, Hhd, Gll^Fdw, Gll^Fdw, Gll^Es, Gs^Fms, Hhd^Es, Hh, Gs^Fds, Gd^Es, Gll, Gs^Efm, Gs, Gll^Fp, Gs^Fds, Gs^Fms, Gs^Fds, Gll^Fp, Gg^Efm, Gs, Gs^Fds, Gs^Fds, Gg^Efm, Ww, Gll^Fp, Gg^Efm, Gll^Fp, Gll^Fp, Gll^Em, Gs^Fds, Gs^Fds, Gs^Fms, Gg^Efm, Gs^Fds, Hh, Gs^Fds, Gll^Fp, Gs^Fds, Wwf, Wwr, Gll^Fp, Wwf^Es, Gll^Fp, Gs^Efm, Gll^Fp, Gll^Fp, Gll^Fp, Gll^Fp, Sm, Wwf^Es, Gll^Fp, Ww, Wwr, Gs^Fds, Gll^Em, Hh, Hh, Gs, Gs^Efm, Hh^Es, Gs^Fms
Wog, Wwg, Ww, Hhd^Es, Ww, Wwf, Wwr, Gd, Gd^Es, Gd^Es, Gll^Fdw, Gd, Gll^Fdw, Re^Edb, Re, Re^Ecf, Re^Vct, Gd^Edb, Gd^Edb, Gd^Edb, Gll, Hhd, Gll^Fdw, Hhd^Es, Gll^Fdw, Gll^Fdw, Gll^Edb, Gd^Edb, Gs, Gs^Fms, Gs^Fds, Gs^Fds, Gg^Es, Gs^Efm, Gs, Gg^Ve, Gs^Es, Wwf, Wwr, Wwr, Wwf^Es, Gll^Fp, Gll^Fp, Gll^Fp, Gs^Fds, Gs^Fds, Hh, Hh, Gs^Fds, Gg^Efm, Gs, Hh, Gll^Fp, Gll^Fp, Wwf^Es, Wwr, Ww, Gll^Fp, Gs^Fds, Gs^Fms, Gs^Fds, Gs, Ss, Gg^Efm, Wwf, Wwr, Gll^Fp, Hh, Hh, Wwr, Ww^Ewf, Gll^Fp, Hh, Gll^Fp, Gll^Fp, Gg^Efm, Hh
Wwg, Wwg, Ww, Ww, Wwr, Wwr, Wwf^Es, Hhd^Es, Hhd, Gll^Fdw, Gs, Gll^Fdw, Gll^Fdw, Re^Vct, Gll^Edb, Re^Es, Gd^Edb, Gll, Gd^Edb, Gd, Re^Edb, Re, Re^Es, Gd^Edb, Gd, Gll^Fdw, Gd^Edb, Gll^Fdw, Gll^Fdw, Gs^Fds, Gs^Fds, Gs^Efm, Gs^Fds, Gs, Gs, Gg^Efm, Gg^Efm, Gs, Wwf, Wwr, Wo, Gs, Wwf, Wwf^Es, Gll^Fp, Gs^Fds, Hh^Es, Gs^Efm, Gg, Gs^Efm, Gg^Es, Gll^Fp, Gs^Fds, Hh, Gg^Efm, Gg^Efm, Ww, Wwf, Gs^Efm, Gs^Fds, Gs^Fds, Ss^Vhs, Gll^Fp, Sm, Ww^Ewl, Sm, Wwf^Es, Gs^Fms, Gll^Fp, Wwf^Es, Gs^Efm, Gll^Fp, Gg, Gs^Fms, Gs^Fms, Hh, Gs^Fds
Wog, Wwg, Wwrg, Ww, Wwr, Wwr, Mm, Gs^Efm, Mm, Mm^Xm, Mm, Gs^Fms, Gll^Fdw, Gll^Fdw, Hhd^Es, Re^Es, Gd^Edb, Gd, Gll, Gll, Gll^Fdw, Gd, Gll^Fdw, Gd^Es, Gll^Edb, Gll^Edb, Re^Vct, Gll, Gll^Fdw, Gll^Fdw, Gs^Fds, Gs^Fds, Gs^Fms, Gs^Fds, Gs^Fms, Gs, Gs^Efm, Gg^Es, Gll^Fp, Gll^Fp, Wwf^Es, Wwr, Wwf, Wwr, Gg^Efm, Gll^Fp, Gs^Fds, Hh, Gs^Fds, Gs^Fds, Gg^Efm, Gs^Fds, Hh, Hh, Gll^Fp, Gs^Efm, Wo, Gs^Fds, Gs^Fds, Sm, Wwf^Es, Sm, Gs^Fds, Gs^Fds, Gs^Fds, Gs^Fds, Wwr, Cme, Ww, Wwr, Hh, Hh, Gg^Efm, Gs^Fds, Gll^Fp, Gll, Gs^Es
Wog, Wog, Wwrg, Wwr, Wwr, Wwf, Mm, Mm, Mm, Mm, Mm, Hh, Gll^Fp, Gll^Fp, Hhd^Es, Gll, Gll, Gd^Edb, Gll^Fdw, Gd^Edb, Re^Es, Gll^Fdw, Gll^Fdw, Gll^Fdw, Gll^Fdw, Re, Re^Edb, Gd^Edb, Hhd^Es, Gll^Fdw, Gs, Gs^Fds, Mm, Gs^Fms, Gs^Efm, Gll, Gll^Fp, Gs, Gs^Fms, Gll^Fp, Gg^Efm, Gs^Efm, Gg, Ww, Gll^Fp, Gll^Fp, Hh, Hh, Gs^Fds, Gg^Ve, Gs^Fds, Gs^Fds, Gs^Fds, Gll^Fp, Gll^Fp, Gs, Wo, Wo, Ww, Wwf, Gs^Fds, Gll^Fp, Gg^Fet, Gs^Efm, Wwf^Es, Gg^Es, Ww, Gll^Fp, Wo, Gs, Hh^Es, Gs^Efm, Gs^Fds, Gs^Fds, Gll^Fp, Gll^Fp, Gll^Fp
Wwg, Wwg, Ww, Ww, Ww, Hh, Wwr, Mm, Gll^Fp, Hh, Gg^Efm, Gs^Efm, Hh, Hh, Gd, Gd^Es, Gs, Gd^Es, Gll^Fdw, Gll^Fdw, Re, Gll^Fdw, Gll^Fdw, Gll^Edb, Gll^Fdw, Gd, Gd^Edb, Gll^Ecf, Hhd, Mm, Mm, Mm, Mm, Gll^Fp, Gll^Fp, Gll^Fp, Gll^Fp, Gs, Gll^Fp, Gs^Fms, Gll^Fp, Gll^Fp, Gs^Efm, Wo, Cme, Gs, Gg^Efm, Gll^Fp, Hh, Hh, Gll^Fp, Gg^Efm, Hh^Es, Gs, Gs^Fds, Gg^Efm, Wwf, Wwf^Es, Gs, Wwr, Gs^Fds, Gs^Fds, Gs^Efm, Gs^Fds, Wo, Ww, Gs^Fds, Wo, Wwf^Es, Wwf, Hh, Gs, Gs^Fds, Gll^Fp, Gll^Em, Gs^Fms, Gs^Fms
Wog, Wwg, Wwrg, Ww, Wwr, Wwr, Wwf^Es, Mm, Mm, Mm, Hh, Gll^Fp, Gs^Fds, Gs^Fms, Gs, Gs, Gs^Efm, Gd^Edb, Gs, Gll^Fdw, Gll^Fdw, Re^Edb, Gll^Edb, Gd, Gd^Edb, Gll^Edb, Re^Vct, Gll^Edb, Re^Es, Mm, Gd^Es, Mm, Mm, Gs^Fms, Mm, Gll^Fp, Gs, Gll^Fp, Gs, Gll^Em, Hh, Gg, Ss, Wwf, Wwr, Wwf, Wwr, Gg, Gs^Efm, Gg^Efm, Gs, Hh, Gs, Gs^Efm, Gs^Fds, Gs^Fds, Gs^Fds, Gs^Fds, Gs^Efm, Ww, Ww, Gs^Fms, Gll^Fp, Wo, Gll^Fp, Wwr, Gs^Efm, Hh, Gs^Fds, Hh, Gg^Es, Gg^Efm, Gs^Efm, Gg^Ve, Gs^Efm, Gs^Fds, Gll^Fp
Wog, Wwg, Ww, Ww, Wwf, Wwr, Mm, Mm^Xm, Mm, Mm, Gs^Fds, Gll^Fp, Gll^Fp, Gs^Fds, Gs^Efm, Gg^Efm, Gs^Fds, Gs^Fds, Gd, Gll^Fdw, Gd^Edb, Gll^Fdw, Gll, Gd, Hhd, Hhd, Re, Hhd, Gll^Edb, Re, Hhd, Mm, Mm, Mm, Mm, Gg^Efm, Hh, Gll^Fp, Mm, Mm, Mm, Hh^Es, Gg, Sm, Sm, Wwf^Es, Wwr, Gs^Efm, Wo, Gll^Fp, Gll^Fp, Gll^Fp, Gs^Fms, Gg^Efm, Gll^Em, Gll^Fp, Gll^Fp, Gs^Fms, Gg^Es, Wo, Gs^Fds, Gll^Fp, Wo, Ww, Gll^Fp, Wwf, Wwr, Ss, Gs^Fds, Gs^Fms, Gs^Efm, Gs^Fds, Gs^Fds, Gg^Efm, Gs^Fds, Gs^Fms, Gll^Fp
Wwg, Wwg, Wwf, Cme, Gs^Efm, Hh, Gll^Fp, Mm, Hh, Hh, Gll^Fp, Gs^Fms, Hh, Gg^Es, Gs^Fms, Gg, Gs^Fds, Gs^Fds, Gs, Gd^Es, Gd, Gd^Es, Gd, Gd^Es, Gll^Fdw, Gll^Es, Hhd^Es, Re^Edb, Gll^Fdw, Gll^Fdw, Re, Hhd^Es, Hhd, Mm, Hhd^Es, Mm, Gs^Efm, Hh, Mm, Mm, Mm, Hh, Gs^Efm, Ss, Gg^Efm, Gs^Fds, Wwf, Ww, Gg^Efm, Wo, Wwf^Es, Gll^Fp, Gs^Fds, Gs, Gg^Fet, Gll^Fp, Gll^Fp, Gll, Ww^Vm, Wo, Ww, Wo, Gs^Fds, Wwf, Gg^Efm, Sm, Hh, Gg, Gll^Fp, Gll^Fp, Gll, Gs^Fms, Gll^Fp, Gs^Efm, Hh, Gs^Efm, Gll^Fp
Wwg, Ww, Ww, Wwr, Wwf, Gg, Gll^Fp, Gll^Fp, Gs^Fms, Gll^Fp, Gll^Fp, Hhd, Gll^Fdw, Gll^Fdw, Gll^Fdw, Gs^Efm, Gs^Es, Gs^Efm, Gd, Gll^Edb, Gd^Edb, Gll^Fdw, Gll^Fdw, Gll^Fdw, Gll^Fdw, Gd^Edb, Re, Hhd^Es, Gll^Fdw, Gll^Fdw, Re^Edb, Gll^Fdw, Gll^Edb, Hhd, Mm, Mm, Mm, Mm, Hh^Es, Gs^Efm, Hh, Gs^Efm, Gs, Gs^Fds, Gs^Fds, Gs^Fds, Gs^Fds, Gs^Efm, Gs^Efm, Ww, Gs^Efm, Gll, Gs^Fds, Gs^Fds, Gs^Fds, Gg^Efm, Wwf^Es, Gs^Efm, Wwr, Ww, Wwr, Ww, Gs^Fds, Gs^Fms, Gs^Fds, Hh^Es, Gg, Gs^Efm, Gg^Efm, Gll^Fp, Hh, Hh, Hh, Hh, Gll^Fp, Hh^Es, Hh
Wog, Wwg, Wwrg, Wwr, Wwr, Hhd^Es, Hhd, Gs, Hhd, Hh, Gll^Fp, Hhd, Gll^Fdw, Gll^Fdw, Gll^Fdw, Gd, Gll^Edb, Gd, Gll^Fdw, Gll^Edb, Hhd^Ecf, Hhd^Es, Gll, Gll^Fdw, Hhd, Hhd^Es, Gll^Fdw, Re, Gd, Gll^Fdw, Re, Re^Vct, Gll^Fdw, Mm, Gll^Fdw, Hhd^Ecf, Hhd, Mm, Mm, Mm, Mm, Hh, Gs^Fds, Gs^Fds, Gs^Fds, Gs^Fds, Gs^Fms, Gs, Gg^Es, Wo, Wo, Gs, Wwf^Es, Gg^Efm, Gll^Fp, Wwf, Wwr, Wwr, Gs^Efm, Gs^Fds, Wwf^Es, Gg^Efm, Gs^Efm, Gll^Em, Gll^Fp, Gs^Fds, Hh^Es, Hh, Gs, Gs^Fds, Gs^Fds, Gg^Efm, Gs^Fds, Gll^Em, Hh, Hh, Gll^Fp
Wog, Wog, Wwg, Wwr, Ww, Gd^Es, Hhd^Es, Gd^Edb, Gll^Fdw, Hhd^Es, Gs^Fms, Gll^Fp, Gd^Es, Gll^Edb, Re^Es, Gll^Edb, Gd^Edb, Gd^Es, Gll^Fdw, Gll^Fdw, Hhd^Edb, Gd^Edb, Gd, Hhd^Es, Gd, Gll^Fdw, Gll^Fdw, Gd^Edb, Gd^Fetd, Gll^Edb, Gll^Fdw, Gll^Fdw, Gll^Fdw, Gll^Fdw, Gll^Fdw, Gd, Mm, Mm, Mm, Mm, Hh, Gll, Gll^Fp, Gll^Fp, Gll^Fp, Gs^Fms, Gs^Fds, Gs^Fds, Gg^Efm, Wwf, Gs, Ww, Wwr, Gll^Fp, Gs^Fds, Ww^Ewf, Ww, Wwr, Wwf^Es, Sm, Gs^Fds, Gs^Efm, Hh, Hh, Gs^Fms, Gll^Fp, Hh, Gs^Efm, Gg^Es, Gs^Fds, Gs^Es, Gs^Fds, Gs^Fds, Gs^Fds, Gg^Fet, Gll^Fp, Gs^Fds
Wwg, Wog, Wwrg, Ww, Wwr, Wwf, Re, Gll^Fdw, Gll^Fdw, Gll^Fdw, Gd, Gs, Re^Edb, Re^Ecf, Re^Es, Re^Vct, Gll^Es, Gll^Fdw, Gll^Fdw, Gll^Fdw, Gll^Fdw, Gll, Hhd^Edb, Hhd, Gll^Fdw, Gll^Fdw, Gll^Fdw, Gll^Fdw, Re, Re^Edb, Gll^Edb, Gll^Fdw, Re, Gll^Fdw, Gll^Fdw, Gll^Fdw, Hhd, Mm, Hh, Hh, Gs^Fds, Gs, Gs^Efm, Gs^Fms, Gll^Em, Gll^Fp, Gg^Ve, Gs^Efm, Gs^Efm, Gg, Gs^Efm, Wwr, Wwr, Gs^Efm, Gs^Fds, Gs^Fds, Gs^Fms, Wo, Wwr, Gg^Es, Gs^Fds, Gs^Fds, Hh, Gs^Fms, Gll^Fp, Hh, Gs, Gg^Efm, Gs, Gg^Efm, Gg, Gs^Fds, Gg, Gs^Efm, Gs^Efm, Gs^Fds, Gg^Efm
Wog, Wwg, Ww, Ww, Wwf, Wwr, Gd^Edb, Re^Edb, Gd^Edb, Gll^Fdw, Re, Gll^Fdw, Gd^Edb, Re, Gll^Edb, Gll, Gll^Fdw, Gd, Gll^Fdw, Gll^Fdw, Gll^Fdw, Gll, Gd^Edb, Gll^Es, Gll^Fdw, Gll^Fdw, Gd, Gll^Edb, Cvr^Es, Cvr^Edb, Hhd^Edb, Gll^Es, Re^Edb, Gll^Fdw, Gll^Fdw, Gll, Mm, Mm, Hh, Gs^Fds, Gs^Fds, Gs^Efm, Gs^Efm, Gs^Es, Gs, Gg^Efm, Gg^Es, Gs^Efm, Gs, Gg^Efm, Gg, Wwf^Es, Wwf, Ww, Wo, Wwf, Cme, Ww, Gs^Efm, Gs^Fds, Gs^Fms, Hh, Hh^Es, Gll, Gs, Gs, Gs^Efm, Gs^Efm, Gs, Gs^Efm, Gg^Efm, Gs, Gll^Fp, Gll^Fp, Gll^Fp, Gs^Fms, Hh
Wwg, Wwg, Wwrg, Wwr, Kme^Edb, Wwr, Wwr, Hhd^Es, Hhd, Re, Gll^Edb, Re, Re^Vct, Gll^Edb, Gd^Fetd, Re^Edb, Gd^Edb, Gll, Gll^Fdw, Gll^Fdw, Gd, Gll^Edb, Hhd^Es, Hhd, Re, Gll^Fdw, Gd^Edb, Hhd, Cvr^Edb, Kvr^Edb, Hhd^Edb, Cvr^Ecf, Gd^Es, Re^Edb, Gd^Es, Mm, Hhd^Edb, Mm, Mm, Mm, Gs^Efm, Gg, Gs, Gg, Gll, Gg^Efm, Gll^Em, Gs, Gg^Es, Gll, Gll^Fp, Gg^Efm, Gs^Es, Gs^Fds, Gs^Fds, Wo, Wo, Wo, Ww, Gs^Fds, Gg^Efm, Gs^Fms, Gll^Fp, Gll^Fp, Gg^Efm, Gs, Gs^Es, Gg, Gg^Efm, Gg, Gg^Efm, Gg^Efm, Gs^Fds, Gs^Fms, Gs^Fds, Gs^Efm, Gll^Fp
Wwg, Wwrg, Ww, Wwr, Wwr, Hhd^Es, Wwf^Es, Hhd, Gd^Edb, Gll^Fdw, Gd, Gll^Edb, Gd^Es, Gd^Edb, Gll, Re^Edb, Re^Es, Gd, Gll, Gd^Es, Gd, Gd^Edb, Gll, Re^Es, Re, Re^Edb, Re, Re, Gd^Es, Cvr^Edb, Re^Vct, Gll, Gll^Fdw, Gll^Fdw, Gll^Fdw, Gd, Gll^Edb, Mm, Mm, Mm, Hh, Hh, Gg^Efm, Gg^Efm, Gll^Fp, Gs^Fms, Gll^Fp, Gs^Fms, Gll^Fp, Gll^Fp, Gg^Es, Gs, Gs^Fms, Gs^Efm, Gs^Fds, Wo, Gs^Efm, Ww, Sm, Wwf^Es, Gg, Gll^Fp, Hh, Hh, Gg, Gs, Gs^Efm, Gg^Efm, Gg^Es, Gs, Gs, Gs, Gg, Gg^Es, Gs^Efm, Hh, Gs^Efm
Wwg, Ww, Ww, Wwr, Wwf^Es, Re^Edb, Re, Re^Es, Gd, Gll^Fdw, Hhd, Gd^Edb, Re, Gll^Fdw, Gll^Fdw, Gd^Edb, Gd^Edb, Gd^Es, Gd^Edb, Gll^Edb, Hhd, Gll, Gd^Edb, Hhd, Hhd, Gd^Es, Gd^Edb, Gll^Fdw, Gll^Fdw, Gd^Edb, Re^Edb, Gll^Edb, Re, Gll^Fdw, Gll^Fdw, Gll, Gd, Hhd, Mm, Mm, Gs^Fms, Gll^Fp, Gll, Gs, Gll^Fp, Gll^Fp, Gll^Fp, Gs^Fms, Gs^Fms, Gll^Fp, Ss, Gll, Gll^Fp, Gg^Efm, Wwf^Es, Wwr, Wwf, Gll^Fp, Ww^Ewf, Ss, Gg^Efm, Gs^Fds, Gs^Fds, Gs^Efm, Gll^Fp, Gs^Efm, Gs, Gs^Efm, Gs, Gs^Efm, Gll^Fp, Gs^Efm, Gg^Efm, Gs^Fds, Gll^Fp, Gs^Fds, Gs^Fds
Wog, Wwrg, Ww, Wwr, Wwf, Gll^Fdw, Gll^Fdw, Gll^Fdw, Gll^Fdw, Hhd^Edb, Gll^Fdw, Gll^Fdw, Re^Es, Gll^Fdw, Gd^Edb, Gll, Gll^Fdw, Gll^Fdw, Gll^Fdw, Gd, Gd^Edb, Hhd^Es, Gll, Gd^Edb, Hhd^Edb, Gll^Fdw, Gll^Fdw, Gll^Fdw, Gll^Fdw, Re^Es, Gll^Fdw, Gll^Fdw, Gll^Fdw, Re^Edb, Gd^Edb, Gd^Edb, Hhd^Es, Hhd, Hhd, Hh, Gg^Es, Gs^Fms, Gll^Fp, Gll^Fp, Gll^Fp, Gll^Fp, Gs^Fms, Gll, Gll^Fp, Gll^Fp, Sm, Gll^Fp, Gll^Fp, Gll, Gs^Efm, Wwr, Gs^Fds, Gs^Fms, Gs^Es, Gg^Fet, Gs, Gll^Fp, Gs^Fds, Gll, Hh, Gs, Gs, Gg, Gll^Fp, Gll, Gs^Fms, Gll^Fp, Gs, Gs^Fms, Gll^Fp, Gs^Fms, Hh
Wwg, Wwg, Wwr, Gd^Es, Re, Gll^Fdw, Gll^Fdw, Gll^Fdw, Re, Re^Es, Re^Es, Gll^Fdw, Gd, Gll^Es, Gd^Ecf, Gll^Fdw, Gll, Gd^Es, Gll^Fdw, Gll, Re, Hhd, Gd, Gd^Edb, Hhd, Gd, Gll^Fdw, Gd, Gll^Edb, Gd, Gll, Gll^Fdw, Gd^Es, Gll^Fdw, Gd, Gll^Edb, Hhd, Gll^Fdw, Hh^Es, Gs^Efm, Gg^Efm, Gll^Fp, Gll^Fp, Gs^Fms, Gs^Es, Gll^Fp, Gll^Fp, Ss, Ss^Vhs, Ww, Wwf^Es, Ss, Gll^Fp, Gs^Es, Wo, Ww, Gs^Fds, Gs^Fds, Gs^Fms, Gg^Efm, Gs^Fds, Gll, Gll^Fp, Gs^Efm, Gll^Fp, Hh, Hh^Es, Gs^Fds, Gs^Fds, Gs^Fds, Gll^Fp, Gs^Fms, Gg^Efm, Gs^Fds, Gs, Gll^Em, Hh
Wog, Wwg, Ww, Hhd^Edb, Hhd^Es, Re^Edb, Gll^Fdw, Gd, Gll^Fdw, Gll^Fdw, Gll, Gll^Fdw, Gll^Fdw, Re^Edb, Re^Edb, Re^Edb, Gll^Fdw, Gll^Fdw, Gd^Es, Gll^Fdw, Gd, Re^Es, Re, Re^Es, Gd^Edb, Hhd, Gll, Gll^Fdw, Hhd^Edb, Gd^Edb, Mm, Gll, Hhd^Edb, Hhd, Mm, Hhd^Es, Gs^Efm, Hhd, Gll^Fp, Gll^Fp, Gll^Fp, Gll^Fp, Ss, Gs^Fms, Gll^Fp, Ss, Ss, Wwf, Sm, Sm, Sm, Gs^Efm, Gg^Efm, Wo, Gs, Wwf^Es, Gs^Fds, Gs^Fds, Gs^Efm, Gg^Ve, Gs^Fds, Gs^Fms, Gs^Efm, Gg, Hh, Gg^Efm, Gs^Efm, Gg, Gs^Fds, Gll^Fp, Gs^Efm, Gll, Gg, Gs, Gg^Efm, Hh, Gll^Fp
Wwg, Wwg, Wwr, Wwf^Es, Gd^Edb, Re^Vct, Gll^Edb, Gd^Es, Hhd, Hhd^Es, Hhd^Es, Gll^Fdw, Gll^Edb, Re^Vct, Gd^Edb, Gll^Fdw, Gd^Es, Gll^Fdw, Gll^Fdw, Gll^Fdw, Gd^Edb, Gll^Fdw, Gll^Fdw, Gd^Edb, Gll^Ecf, Gd, Gll^Edb, Gd^Edb, Gll, Hhd^Vhhr, Mm^Xm, Hhd, Mm, Hh, Gs^Fds, Mm, Gs^Fms, Gs, Gll^Em, Gll^Fp, Gll^Fp, Gll, Sm, Sm, Sm, Ss, Sm, Ss, Ww, Wwf, Ss, Sm, Wwf^Es, Ww, Wwr, Gs^Efm, Gs^Efm, Gll, Gll^Fp, Gs^Fds, Gs^Fds, Gs^Fds, Gs^Efm, Gs, Gll^Fp, Gs, Gg^Efm, Hh, Gs, Gg^Efm, Gg, Gs, Hh, Gs^Efm, Gs^Fds, Gs^Fds, Gs^Fds
Wwg, Ww, Wwf^Es, Hhd^Edb, Hhd^Ecf, Gll^Fdw, Gll^Fdw, Gll, Gll^Fdw, Gd, Gll^Es, Gd, Hhd^Es, Gll^Edb, Wwf, Gll^Fdw, Wwrg, Gll, Hhd, Gd^Es, Wwf^Es, Gll^Fdw, Gll^Fdw, Gd, Gll^Fdw, Gll^Es, Gll^Fdw, Gll, Gd^Es, Mm, Mm, Mm, Gs^Fds, Mm, Gs^Fds, Gs^Fds, Gs^Fms, Gg^Es, Gll^Fp, Gll^Fp, Gll, Ww^Ewf, Ww, Ss, Ss, Wwf^Es, Wwf, Ww^Ewl, Sm, Sm, Ss, Ss, Sm, Wwr, Wwf, Gg, Gs^Efm, Gll^Fp, Gll^Fp, Gs^Fms, Gll^Fp, Gll^Fp, Hh, Gll^Fp, Gll^Em, Hh^Es, Hh, Hh, Gs, Gll^Fp, Hh, Gs^Efm, Gg^Efm, Hh, Hh, Gs^Fds, Hh
Wwg, Ww, Ww, Gll^Fdw, Hhd^Es, Hhd^Edb, Hhd, Wwr, Wwr, Gll^Fdw, Wwr, Gd, Wwg, Hhd, Wwg, Ww, Wwrg, Ww, Wwf^Es, Wwr, Wwg, Wwf, Gll^Es, Hhd^Edb, Gll^Fdw, Gll^Fdw, Gd, Gs^Efm, Gs^Fds, Mm, Mm, Mm, Gs, Gg^Efm, Gs^Fds, Gs^Fds, Gs^Efm, Gll, Gll^Fp, Gll^Fp, Gll^Fp, Gs^Efm, Ss, Sm, Gs^Efm, Sm, Ss, Ss, Wwf^Es, Ww, Gll^Fp, Hh, Hh^Es, Wwr, Gs^Efm, Sm, Gs^Efm, Gg^Efm, Gll^Fp, Gll, Gs^Efm, Gg, Hh, Gll^Fp, Gll^Fp, Gs^Fms, Gll^Fp, Gg^Efm, Hh, Gs^Fms, Gll^Fp, Hh^Es, Hh, Hh, Gs^Efm, Hh^Es, Gll^Fp
Wwg, Wwg, Wwg, Wwg, Wwg, Wwr, Ww, Wwg, Ww, Ww, Ww, Ww, Wwf^Es, Wwg, Ww, Wwrg, Wwrg, Wwrg, Wwf, Wwg, Wwg, Ww, Wwg^Bsb|, Ww, Wwr, Gll^Fdw, Wwf^Es, Gs^Fds, Gs, Gs^Efm, Gs^Efm, Gg, Mm, Mm, Gs^Efm, Gs^Fms, Mm, Gs^Fms, Gll^Fp, Gll^Fp, Gll^Fp, Gg, Gll, Gll^Fp, Gll^Fp, Gs^Efm, Gll^Fp, Gll^Em, Gg^Efm, Gll^Fp, Hh, Gll^Fp, Cme, Wo, Wwf^Es, Gs^Es, Gs^Efm, Gg, Gg^Efm, Gg, Gs^Efm, Gg^Efm, Hh, Gg^Efm, Gll^Fp, Gll^Fp, Gll, Gll^Fp, Gs, Gll^Fp, Hh, Gg^Efm, Gs^Fds, Gs^Fds, Gg^Efm, Gll^Fp, Gs^Fms
Wog, Wog, Wwg, Wwr, Kme^Edb, Ww, Kme^Edb, Wwr, Cvr^Edb, Ww, Wwr, Wwr, Hhd^Es, Gll^Fdw, Gll^Fdw, Kme^Edb, Hhd, Hhd^Es, Hhd, Hhd^Es, Gll^Fdw, Wwf^Es, Gll^Fdw, Ww, Wwr, Wwf, Ww, Hh, Gs^Fds, Gg^Efm, Hh, Hh, Gs^Efm, Mm, Mm, Mm, Mm, Gs^Efm, Gs^Efm, Gll, Gg^Es, Gs^Efm, Gs^Fms, Gll^Fp, Gll^Em, Gll^Fp, Gs^Fms, Gll^Fp, Wwf^Es, Hh^Es, Wwf, Gll^Em, Wwr, Ww, Hh, Gs^Fds, Gs^Fds, Gs^Fds, Gg^Efm, Gs^Fds, Gg, Hh, Gs^Efm, Gg^Es, Hh, Gs^Fms, Gs^Efm, Hh, Hh, Gg^Efm, Hh, Gs^Fds, Gs^Fms, Gs^Fds, Gll, Hh^Es, Hh
Wog, Wwg, Wwr, Kme^Es, Kme^Edb, Wwr, Gd, Cvr^Edb, Gll^Fdw, Kvr^Ecf, Cvr^Es, Hhd, Hhd^Es, Hhd^Edb, Gd^Fetd, Gll^Fdw, Gll^Fdw, Gd, Gll^Fdw, Gll^Fdw, Gd^Es, Gll^Fdw, Gd^Edb, Hhd^Ecf, Wwf^Es, Wwr, Ww, Wwg, Wwg, Wwf^Es, Wwrg, Ww, Gg^Efm, Gs, Gg^Es, Gs^Efm, Gs^Fds, Gg, Mm, Mm, Hh^Vhh, Gs, Gs^Efm, Gg, Gs^Efm, Gs^Fms, Hh, Gs^Efm, Wo, Wwr, Ww, Wwr, Hh, Wwf, Gg^Efm, Gs^Fds, Gs^Fds, Gs^Fds, Gs^Fds, Gs^Fds, Gs, Gs^Efm, Gg, Gs^Fds, Gs^Efm, Hh^Es, Gs^Fds, Gll, Gs^Efm, Gll^Fp, Hh^Es, Gll^Fp, Gs^Fms, Hh, Gll^Fp, Gll^Fp, Gs^Efm
Wog, Wwg, Wwr, Wwr, Ww, Wwf^Es, Hhd^Es, Hhd, Re^Vct, Hhd, Gll^Fdw, Gd^Edb, Hhd, Gll^Fdw, Gll^Fdw, Gll^Es, Gd, Gll^Edb, Re^Edb, Gll, Gll^Fdw, Re^Es, Re, Hhd^Edb, Hhd^Es, Wwr, Hhd^Es, Wwr, Wwg, Wwg, Wwg, Wwg, Wwf^Es, Hh, Gs, Gs^Fds, Gs^Fds, Gs^Fds, Mm, Mm, Gg^Fet, Gs, Gg^Efm, Gs, Gs^Efm, Gs^Fds, Hh, Ww, Hh, Wo, Wwf^Es, Wwf, Hh, Gs^Efm, Gg^Ve, Gg, Gs^Efm, Gs^Fds, Gg^Es, Gs^Efm, Gg^Efm, Gs^Efm, Gs, Gs^Fds, Hh, Hh, Gs^Fds, Gll^Fp, Hh, Gs^Fms, Gll^Fp, Gll^Em, Gg^Efm, Gg, Hh, Gs^Efm, Gs^Fds
Wwg, Wwg, Wwg, Ww, Hhd^Es, Gll^Fdw, Wwf^Es, Gll^Fdw, Re^Edb, Gll^Fdw, Cvr^Edb, Gll, Cvr^Edb, Re^Edb, Re^Edb, Gd, Gll^Fdw, Re, Gll, Gll^Fdw, Gll^Fdw, Gll^Fdw, Gll^Es, Gll^Fdw, Gd, Hhd, Hhd, Kme^Es, Hhd, Hhd^Es, Wwrg, Wwg, Wwrg, Wwf^Bsb/, Gs^Efm, Gs^Efm, Gs^Fds, Gs^Fds, Mm, Mm, Mm, Gg^Efm, Gs^Fds, Gs^Fds, Hh, Wwf, Wwf^Es, Wwr, Hh, Hh, Gs^Fms, Gs^Efm, Gg^Es, Gs, Gs^Fms, Gll^Fp, Gll^Fp, Gll, Gs^Efm, Gs^Efm, Gg, Gs, Gg^Efm, Gs, Gg^Efm, Gs^Fds, Gs^Efm, Gll^Fp, Gs^Fds, Gll^Fp, Gg^Efm, Gll^Fp, Gs^Fds, Gs^Fds, Gs^Efm, Gs^Fds, Gs^Fds
Wog, Wwg, Wog, Wwg, Wog, Hhd^Es, Wwg, Ww^Bw/r, Wwf^Es, Gll^Es, Cvr^Edb, Kvr^Edb, Kvr, Cvr^Edb, Cvr^Edb, Gll^Fdw, Gll^Fdw, Gd^Es, Gll^Fdw, Gll^Fdw, Gll^Fdw, Gd, Gll^Fdw, Gll^Fdw, Gll^Es, Gll^Fdw, Gll^Fdw, Gll^Fdw, Gd, Gll^Fdw, Gd^Es, Wwrg^Bsb/, Wwrg, Wwf^Es, Wwf, Hh, Gs^Efm, Mm, Gs^Efm, Mm, Gll^Fp, Gs, Gg^Efm, Gs^Fds, Ww, Ww^Vm, Wo, Wwr, Gs^Efm, Gs^Fms, Gll^Fp, Gll^Fp, Gll, Gs^Efm, Gll^Em, Gll^Fp, Gll^Fp, Gll^Fp, Gg^Efm, Gs^Efm, Gg^Fet, Gg^Efm, Gs^Fds, Gs^Fds, Gs^Efm, Gs, Gs^Fds, Hh, Gs^Fds, Gs, Hh, Gs^Fds, Gs^Fms, Gs^Fms, Gs^Fds, Gs^Fms, Gs^Fds
Wog, Wog, Wwg, Wog, Wwg, Wog, Wwg, Wog, Wwr, Gll^Fdw, Cvr^Edb, Kvr^Edb, Cvr^Edb, Cvr^Ecf, Gll^Fdw, Gll^Fdw, Gll^Fdw, Gd^Edb, Gd^Edb, Gll^Fdw, Gll, Gd^Edb, Gll^Fdw, Gll^Fdw, Re^Edb, Re^Edb, Gll^Fdw, Gll, Gd^Es, Hhd, Gll^Fdw, Wwf, Wwf^Es, Wwrg, Ww, Wwf^Es, Mm, Gs^Fms, Mm, Mm, Gs^Fms, Gs^Fms, Mm, Hh, Wwr, Wo, Gs^Efm, Wwf^Es, Gll, Gll^Fp, Gs^Fms, Gll^Fp, Gs^Fds, Gs^Fds, Gs^Fds, Gll^Fp, Gs^Efm, Gg, Gs, Gg, Gs^Es, Gs, Gs^Fds, Gs^Fds, Gs^Fds, Gg^Es, Gg, Gs^Efm, Hh, Gs^Fds, Gll, Gs^Efm, Hh, Gll^Fp, Gs^Fds, Hh^Es, Gs^Efm
Wwg, Wwg, Gll^Fdw, Gll^Fdw, Gll^Fdw, Wwg, Gll^Fdw, Ww^Bw\r, Re^Edb, Gd^Es, Gll^Fdw, Gll^Fdw, Gll^Es, Gll^Edb, Re^Edb, Re^Vct, Gd^Es, Gll^Es, Gd, Gll^Fdw, Re^Es, Re^Es, Gll, Gd^Fetd, Gll^Es, Re^Vct, Gll^Edb, Re, Re^Edb, Re^Edb, Hhd^Es, Hhd, Wwr, Ww, Hh, Mm, Mm, Gll^Fp, Gs^Fms, Gll^Fp, Gll^Fp, Mm, Wwf^Es, Wo, Wwf, Gs^Es, Gs^Fds, Gg^Efm, Gg^Fet, Gs^Fms, Gs^Fds, Gs^Fds, Gs^Fds, Gs^Fds, Gs^Efm, Gs^Fms, Gs^Efm, Gs^Efm, Gll^Em, Gll^Fp, Gll^Fp, Gs^Efm, Gg^Efm, Gs, Gg, Gs^Fds, Gg^Efm, Hh, Gll^Em, Gll^Fp, Gs^Fms, Gll^Fp, Hh^Es, Gll^Fp, Gll^Em, Hh, Hh^Es
Wwg, Wwr, Gd^Es, Hhd, Hhd^Edb, Gll, Cvr^Edb, Re^Edb, Cvr^Edb, Gd^Fetd, Gll, Gll^Fdw, Gd^Es, Gll^Fdw, Re^Ecf, Re^Edb, Gll^Fdw, Gll, Gll^Fdw, Re^Edb, Re, Gll, Gd, Gll^Fdw, Gll^Fdw, Gd^Edb, Gll^Fdw, Gd^Es, Gll^Fdw, Gd^Es, Gll, Hhd^Es, Wwf, Wwg, Wwrg, Hh, Hh, Gll^Fp, Gs^Fms, Gll^Fp, Gll^Fp, Gll^Fp, Hh^Es, Wwr, Hh, Gs^Fds, Gs^Fds, Gs^Fds, Gs^Efm, Gs^Efm, Gs^Fds, Gs^Fds, Gs^Efm, Gs^Fds, Gs, Gs^Fds, Gs^Fds, Gg^Efm, Gll^Fp, Gll^Fp, Gs^Fms, Gs^Fds, Gs^Fds, Gg^Efm, Gs^Fds, Gs^Efm, Gs^Efm, Gg, Hh, Gll^Fp, Gs^Fms, Gg^Efm, Hh, Gg, Gs^Fds, Gll^Fp, Gll^Fp
Ww, Wwr, Kme^Edb, Kme^Edb, Kme^Es, Cvr^Edb, Gll^Fdw, Kvr^Edb, Gll^Edb, Gll^Fdw, Gll^Edb, Gll^Fdw, Gll^Fdw, Gll^Fdw, Hhd^Edb, Gll^Fdw, Gll^Fdw, Gll^Fdw, Gll^Fdw, Gd, Gll^Fdw, Hhd^Es, Gd^Edb, Gll^Fdw, Re^Vct, Gd^Ecf, Gll^Fdw, Gll^Fdw, Gll^Fdw, Gll^Edb, Hhd, Kme^Edb, Wwf^Es, Wwg, Wwg, Wwf^Es, Mm, Gll^Fp, Gll^Fp, Gs^Fms, Gll^Fp, Gll^Em, Wwr, Wwr, Wwf, Gg^Efm, Gs^Fds, Gs^Fds, Gg, Gs^Fds, Gs^Fds, Gs^Efm, Gs^Es, Gg^Efm, Gll^Fp, Gs^Fds, Gs^Fms, Gs^Fds, Gll^Em, Gll^Fp, Gs^Fms, Gg^Efm, Gg^Es, Gs^Efm, Gs^Fds, Gs, Gg^Efm, Gs, Gs^Fms, Hh^Vhh, Gs^Fds, Gs^Fds, Gs^Efm, Gg^Fet, Gs^Fds, Gs^Fms, Hh
Wwg, Ww, Wwr, Kme^Edb, Wwr, Hhd^Edb, Gll^Es, Gll^Fdw, Wwf^Es, Hhd, Gd^Es, Hhd^Es, Hhd, Hhd^Edb, Hhd, Hhd^Es, Hhd, Gll, Gd^Es, Gll^Fdw, Gll, Hhd^Es, Hhd^Edb, Re^Edb, Hhd^Edb, Re^Edb, Gd^Es, Gll^Fdw, Gd, Gd, Hhd^Es, Wwr, Wwr, Wwrg, Wwrg, Ww, Wwf^Es, Hh, Hh^Es, Gs, Cme, Hh, Ww, Wwf^Es, Gg^Efm, Gs^Fds, Gs^Fds, Gs^Fds, Gs^Es, Gs^Fds, Gs^Fds, Gs^Fds, Gs^Efm, Gll, Gll^Fp, Gs^Fds, Gll^Fp, Gll^Fp, Gs^Efm, Gg, Gs^Fds, Gs^Fds, Gs^Fds, Gs^Fds, Gs^Fds, Gs^Fds, Gll^Em, Gll^Fp, Gll^Fp, Hh, Gg, Gs^Efm, Gg, Gs^Efm, Gs^Efm, Hh, Hh
Wwg, Wwr, Wwr, Ww, Wwr, Wwr, Ww, Gll^Fdw, Wwr, Ww, Ww, Gll^Fdw, Ww, Wwr, Wwr, Gd, Ww, Gll^Es, Kme^Es, Hhd^Es, Wwr, Wwf^Es, Gd^Es, Hhd^Es, Wwf, Gll, Wwf, Kme^Edb, Hhd, Hhd^Es, Wwr, Wwf^Es, Wwrg, Wwg, Wwg, Wwr, Wwrg, Hh, Ww, Wwf, Ww, Wwf^Es, Wo, Wwf, Cme, Gs, Wwr, Gg^Efm, Gs^Efm, Gs, Gs^Fds, Gs^Fds, Gs^Fms, Gs^Fds, Gs^Fms, Gll^Fp, Gll^Fp, Gll^Fp, Gs^Es, Gs^Efm, Gs^Fds, Gs^Fds, Gs^Fds, Gs^Fds, Gs^Efm, Gll^Fp, Gs, Gll^Fp, Hh, Gll^Fp, Gs^Efm, Gs^Fds, Gs^Fds, Hh, Gs^Fms, Gs^Fds, Gs^Fds
Wwg, Wwg, Wwg, Wwg, Ww, Ww, Ww, Wwr, Wwg, Wwg, Wwr, Wwr, Ww, Wwg, Ww, Ww, Wwr, Wwr, Ww, Ww, Ww, Wwr, Ww, Ww, Ww, Ww, Ww, Wwf, Ww, Wwr, Ww, Wwrg, Wwrg, Wwrg, Wwg, Wwg, Wwg, Ww, Wwg, Ww, Wog, Wo, Wog, Ww, Ww, Wwf, Wwr, Wwr, Gg, Gg^Efm, Gs^Fds, Gs^Fds, Gll^Fp, Gll^Fp, Gll^Fp, Gll^Fp, Gll^Fp, Gs^Efm, Gg, Gs^Fds, Gg, Gs^Fds, Gs^Fds, Gs^Fds, Gs^Fds, Gs^Fds, Gs^Efm, Gs^Efm, Gg, Hh, Hh, Gs^Fds, Gs^Fds, Hh, Gs^Fms, Hh, Gg
