Gs^Fds, Gs^Fds, Gs^Fds, Gs^Fds, Gg^Efm, Gll^Fp, Gll^Fp, Gg, Gs^Fds, Gs^Efm, Gs^Fds, Gs^Fds, Gg^Efm, Gs^Fds, Gs^Fds, Gs^Fds, Gs^Fds, Gg, Gs^Fds, Gs^Fds, Gll^Fp, Wwf, Wwf, Wo, Wwf, Gs, Gs^Efm, Gs^Fds, Gs^Fds, Gs, Gs^Efm, Gg, Gs^Fds, Gs^Fds, Gs^Fds, Gs^Fds, Gs^Fds, Gs^Fds, Gs^Fds, Gg, Gs^Fms, Gg
Gg^Efm, Gs^Fds, Gs^Efm, Gs^Efm, Gg^Fet, Gll, Gs^Efm, Gs^Fds, Gs^Efm, Gs^Efm, Gs^Fds, Gs^Fds, Gs^Fds, Gs^Fds, Gs^Fds, Gs^Fds, Gs^Fds, Gs^Fds, Gs^Fds, Gll, Gll^Fp, Gs^Efm, Gs^Efm, Wo, Wwf, Gs^Fds, Gs^Fds, Gs^Fds, Gs^Fds, Gs^Fds, Gs, Gs^Efm, Gs^Fds, Gg^Efm, Gs^Fds, Gs^Fds, Gs^Fds, Gs^Fds, Gs^Fds, Gs^Fds, Gll^Fp, Gs^Fms
Gs^Fds, Gs^Fds, Gs^Fds, Gs^Fds, Gs, Gg^Efm, Gs^Fds, Gs^Fds, Gs^Fds, Gg^Ve, Gs^Fds, Gs^Fds, Gs^Em, Gs^Fds, Gs, Gs^Fds, Gs^Fds, Gs^Fds, Gs, Gg^Efm, Sm, Gll^Fp, Ww, Wo, Ww^Ewl, Gs^Efm, Gs^Fds, Gs^Fds, Gs^Fds, Gs^Fds, Gg, Gs^Fds, Gll^Fp, Gll, Gs, Gs^Fds, Gs, Gs^Es, Gs^Fds, Gs^Fms, Gs^Fms, Gll^Fp
Gs, Gg^Efm, Gs^Fds, Gs^Fds, Gs, Gs^Fds, Gs^Fds, Gs^Efm, Gs^Fds, Gg, Gs^Fds, Gll, Gll^Fp, Gs^Fms, Gg^Efm, Gs^Fds, Gg^Efm, Gs^Fds, Gs^Fds, Gs^Fds, Gs^Efm, Wwf, Wo, Ww, Gg, Gs^Fds, Gs^Fds, Gg^Em, Gg^Efm, Gs, Gs^Efm, Gs^Fms, Gll^Fp, Gs^Fms, Gs^Efm, Gs^Fds, Gg, Gs^Fds, Gs^Efm, Gll^Fp, Gll, Gll^Fp
Gs^Efm, Gg^Es, Gs, Gs, Gg^Efm, Gg^Efm, Gs^Fds, Gs^Fds, Wwf, Gg^Efm, Gs^Efm, Gll^Fp, Gs, Gll^Fp, Wwf, Gs^Fds, Sm, Ss, Gs^Efm, Gs^Fds, Ww, Wo, Ww, Ww, Gs^Efm, Gs^Fds, Ss, Sm, Wwf, Ww, Wwf, Sm, Gs^Efm, Gg^Ve, Gs, Gg, Gs^Efm, Gg^Efm, Gs^Fds, Gg^Em, Gs^Fds, Gs^Fms
Gs^Fds, Gs^Efm, Gs^Fds, Gs, Gs, Gs^Efm, Gg, Gs^Fds, Wwf, Ww, Ww, Wwf, Ww, Gs^Efm, Ww, Gs^Fds, Gs, Wwf, Wwf, Wwf, Ww^Ewf, Ww^Ewl, Ww, Gg^Efm, Ww, Gg, Gs^Efm, Gg, Gg^Efm, Gs^Fds, Gg^Es, Wwf, Sm, Gs^Efm, Gs^Fds, Gs^Fds, Gs^Fds, Gs^Fds, Gs^Fds, Gs, Gs^Fds, Gg
Gs^Fds, Gs^Fds, Gs^Fds, Gg^Efm, Gs, Gg, Gs^Efm, Wwf, Ww, Ww^Ewl, Wo, Ww^Ewf, Ww, Ww, Wwf^Es, Ww, Ww, Ww, Wo, Wwf, Ww, Ww, Gs^Fds, Ww, Wo, Gs^Efm, Wo, Ww^Ewl, Ww, Gs^Fds, Ww, Sm, Ss, Gg, Gg^Fet, Gg, Ss, Gg^Efm, Gg^Efm, Gg^Efm, Gs^Fds, Gs^Fds
Gs, Gs^Fds, Gs^Fds, Gs^Fds, Gs^Fds, Wwf, Ww, Ww^Bsb\, Cv, Ww, Wwf, Ww, Cv, Wwf, Kv, Cv, Cv, Wo, Gg^Fet, Ww, Wwf, Wwf, Ww, Wwf, Ww, Wo, Ww, Wo, Ww, Wo, Ww, Gs^Efm, Gs, Gs, Gs^Es, Sm, Ww, Gs^Fds, Gs^Fds, Gs^Fds, Gg^Efm, Gg^Efm
Gs^Fds, Gs^Efm, Gs^Fds, Gs^Em, Gs, Ww, Wwf, Ww, Wo, Ww^Bsb\, Gg^Fet, Gs^Efm, Gg^Efm, Cv, Gs^Fds, Gs^Fds, Gs^Fds, Gs^Efm, Gs^Fds, Gs^Fds, Cv, Cv, Kv, Wwf^Es, Cv, Ww, Wwf, Gg^Fet, Cv, Wo, Ww, Gs^Efm, Wwf, Gs^Efm, Gg^Efm, Gg, Sm, Gg, Gs^Efm, Gg, Gs^Fds, Gs^Efm
Gs^Fds, Gs^Fds, Gs^Fds, Gg^Efm, Gs^Fds, Gg, Wwf^Es, Ww^Ewf, Ww, Ww, Gs^Fds, Gs^Fds, Gs^Efm, Gs, Gs^Fds, Gs^Fds, Gs, Gs^Efm, Gg, Gg^Efm, Gg^Efm, Gs, Gs, Cv, Gg, Gs^Fds, Gg^Efm, Gs^Fds, Cv, Ww, Wwf, Ww^Ewl, Ww, Gs, Wwf^Es, Gs, Gg, Gg^Em, Gs^Fds, Gs^Efm, Gs^Fds, Gs^Fds
Gs^Fds, Gg^Efm, Gs^Fds, Gs^Fds, Gs^Efm, Wwf, Wo, Ww^Ewl, Ww, Wwf, Gs^Fds, Gs^Fds, Gs^Fds, Gs, Gs, Gs^Fds, Gg, Gs^Fds, Gs^Fds, Gs^Fds, Gs^Fds, Gs, Gs^Fds, Gs^Fds, Gs^Fds, Gg, Gs^Efm, Gs^Fds, Gs^Fds, Kv, Cv, Ww, Ww, Wwf, Cv, Gs, Gg^Efm, Gs^Fds, Gs^Fds, Gs^Fds, Gs^Fds, Gs^Fds
Gg^Efm, Gs^Fds, Gg^Em, Ss, Gg^Es, Ww, Wo, Ww, Wwf, Cv, Gg, Gs^Fds, Gs, Gs^Efm, Gg, Gg^Efm, Gs^Efm, Gg, Gs^Fds, Gs^Fds, Gs^Fds, Gs^Efm, Gs, Gg^Efm, Gg^Efm, Gs^Fds, Gs^Efm, Gg^Efm, Gs^Fds, Gg, Cv, Wwf, Gg^Fet, Ww^Bsb/, Wo, Ww, Ss, Gg, Gs^Fds, Gs^Fds, Gg^Efm, Gs^Fds
Gg, Gs^Fds, Gs, Sm, Wwf, Wo, Ww^Ewl, Ww, Kv, Cv, Gs, Gs^Fds, Gg^Efm, Gs, Gs^Fds, Gg^Efm, Gs, Gg, Cv^Ii, Kv^Ii, Cv^Ii, Gg, Gg^Efm, Gs^Fds, Gs, Gs, Gs, Gs^Fds, Gs^Fds, Gs^Fds, Gs, Gs^Fds, Gs^Fds, Ww, Wo, Ww^Ewf, Sm, Ss, Gs^Efm, Gs^Fds, Gg, Gs^Fds
Gs^Efm, Gs^Efm, Wwf, Sm, Gs^Fds, Wo, Ww, Wwf, Cv, Gs^Efm, Gs, Gg^Efm, Gg^Efm, Gg, Gs^Fds, Gs^Fds, Cv^Ii, Gg, Gs, Gg^Efm, Gs, Gg, Cv^Ii, Gg^Efm, Gs, Gg^Efm, Gs^Fds, Gs, Gg^Efm, Gg, Gs^Fds, Gs, Cv, Ww, Ww, Ww^Ewl, Gs^Efm, Gg, Gg^Ve, Gg^Efm, Gs, Gs^Fds
Gs^Fds, Gs^Efm, Ww, Wwf, Ww, Wwf, Wwf^Es, Cv, Gs^Fds, Gg, Gs^Fds, Gs^Fds, Gs, Gs, Gg, Gs^Fds, Kv^Ii, Gs^Efm, Gg^Efm, Gg^Fet, Gg^Efm, Gs^Efm, Kv^Ii, Gg, Gs^Fds, Gs^Fds, Gs^Fds, Gs, Gg^Efm, Gg^Efm, Gs^Fds, Cv, Wwf, Ww, Gs^Fds, Ww, Gs^Efm, Gs^Fds, Gs^Fds, Gs^Efm, Gs^Fds, Gg
Gs^Fds, Gg^Efm, Gs^Fds, Ww, Wo, Ww, Gg^Fet, Gs^Fds, Gs^Fds, Gg^Efm, Gs^Fds, Gs^Fds, Gg^Efm, Gs^Fds, Gs^Fds, Cv^Ii, Gs^Efm, Gs^Efm, Gs, Gg, Gs^Efm, Gs, Gs^Efm, Cv^Ii, Gg^Efm, Gs^Fds, Gg^Efm, Gs^Fds, Gg, Gs, Gg^Efm, Kv, Ww, Ww, Wwf, Wwf, Gs^Fds, Gs^Fds, Gg^Efm, Gg, Gs^Fds, Gs^Fds
Gll^Fp, Gs^Fms, Gs^Fds, Ww^Ewl, Wo, Wwf, Ww, Gg, Gs^Fds, Gs^Fds, Gg, Gs^Fds, Gs^Efm, Gs^Fds, Gg, Gg, Gs^Efm, Gs^Efm, Cv^Ii, Gs^Efm, Cv^Ii, Gs, Gg^Efm, Gg, Gs, Gg^Efm, Gs^Fds, Gs, Gs^Efm, Gs, Cv, Cv, Ww, Wo, Ww, Ww, Gs^Efm, Gs^Fds, Gs^Fds, Gs^Fds, Gs^Fds, Gs^Fds
Gll^Fp, Gll^Fp, Gs^Efm, Gs^Efm, Ww, Wo, Ww, Wwf, Cv, Gg^Efm, Gs^Efm, Gg, Gs, Gs^Efm, Gg, Gs, Gs^Fds, Gg, Gs^Fds, Kv^Ii, Gg, Gs^Fds, Gs^Fds, Gg, Gg^Efm, Gs^Fds, Gs, Gs^Fds, Gs^Fds, Gg^Efm, Wwf, Ww, Wo, Wo, Wwf, Gs^Efm, Gs, Gg, Gs^Fds, Gs^Fds, Gg^Es, Gs^Fds
Gs^Fms, Gs^Fds, Gs^Fms, Gs, Ww, Wo, Ww^Ewf, Ww, Cv, Gs^Fds, Gs^Fds, Gs^Fds, Gs^Fds, Gg, Gs^Fds, Gg^Efm, Gs^Fds, Gs^Fds, Gs^Fds, Gg^Efm, Gs^Fds, Gs^Fds, Gs^Efm, Gs^Fds, Gg^Efm, Gs, Gs^Fds, Gs^Fds, Gg, Gs, Gg^Fet, Ww, Wo, Wwf, Wwf, Sm, Ss, Gg, Gs^Efm, Gs^Efm, Gs, Gs^Efm
Gll^Em, Gll^Fp, Gg, Wwf^Es, Wwf, Ww, Wo, Ww, Wwf, Kv, Cv, Gg, Gs^Efm, Gg^Efm, Gs^Fds, Gs^Fds, Gs, Gs, Gg, Gg^Efm, Gg, Gs^Fds, Gs^Efm, Gs^Efm, Gg, Gs^Fds, Gg, Gs^Fds, Cv, Gs^Efm, Ww, Ww^Bsb\, Cv, Ww, Gs^Es, Sm, Gg, Gs^Efm, Gs^Efm, Gs^Efm, Gs^Fds, Gg^Efm
Gg, Gs^Fms, Ss, Sm, Gs^Efm, Ww, Wo, Wo, Wwf, Wwf, Cv, Gs^Fds, Gs^Fds, Gg, Gg^Efm, Gg^Efm, Gs, Gs^Fds, Gg^Efm, Gs, Gs, Gg^Efm, Gg, Gs^Efm, Gg, Cv, Cv, Kv, Wwf, Cv, Wo, Ww^Ewf, Ww, Wwf^Bsb\, Gs^Efm, Gg, Gs, Gs^Efm, Gg^Em, Gs^Fds, Gs^Fds, Gs^Fds
Gs, Gs, Ss, Gg, Wwf, Ww^Ewf, Ww, Wo, Wo, Ww, Wwf, Gs^Fds, Gs, Gs, Gg, Gs^Fds, Gs^Fds, Gg^Efm, Gs^Fds, Gs^Efm, Gs, Gg^Efm, Gs^Fds, Gg, Gs^Fds, Gs^Efm, Gs, Wwf, Ww^Ewf, Ww, Ww, Gs^Fds, Gs^Fds, Gs^Fds, Gg^Efm, Gs^Fds, Gs^Fds, Gs^Fds, Gs^Fms, Gs^Fms, Gs^Fms, Gs^Fds
Gs^Fds, Gg^Efm, Gg^Ve, Sm, Gs^Efm, Wwf, Ww, Ww^Ewl, Wo, Ww, Gg^Fet, Gg^Efm, Gs^Fds, Gs^Fds, Gs, Gg, Gs^Fds, Gs^Fds, Gg, Gg^Efm, Gg^Efm, Gs^Fds, Gs^Fds, Gg, Gg^Efm, Gs^Efm, Gg^Fet, Wwf, Wo, Wo, Wwf, Gs, Gs^Fds, Gs^Fds, Gs^Efm, Gs^Fds, Gs^Fds, Gs^Fms, Gg^Efm, Gll^Fp, Gll^Fp, Gs^Fds
Gs^Fds, Gg^Es, Gs^Efm, Gs^Efm, Gs^Fds, Ww, Gg^Efm, Ww, Cv, Ww^Bsb/, Ww, Wwf, Cv, Gs^Fds, Kv, Cv, Cv, Gs^Fds, Gg^Efm, Gs^Fds, Gs^Fds, Gs^Fds, Gs^Fds, Gs^Fds, Wwf, Ww^Ewl, Ww, Ww, Wo, Ww, Ww, Wwf, Gg, Gg^Ve, Gs^Fds, Gs^Fds, Gs^Fms, Gll^Fp, Gll^Fp, Gll^Fp, Gll^Fp, Gs^Fms
Gs^Fds, Gs^Fds, Gg, Gs^Fds, Gs^Fds, Gs^Efm, Gs^Efm, Gs, Sm, Ww, Wo, Wwf, Ww, Cv, Ww, Wwf, Wwf, Gs^Fds, Gg^Fet, Gs^Fds, Cv, Cv, Kv, Gg, Cv, Ww, Wo, Wo, Ww, Ww, Wo, Gs^Fds, Gs^Fds, Gs^Fds, Gs^Efm, Gs^Fds, Gs^Fds, Gs^Fms, Gll^Fp, Gll^Fp, Gll^Fp, Gs^Fms
Gs^Fds, Gs^Fds, Gs^Fds, Gs^Fds, Gg, Gs^Fds, Gg, Ss, Gs, Gs^Efm, Wwf, Wo, Gs^Fds, Ww, Ww, Ww, Wo, Wwf, Ww, Wwf, Ww, Wwf^Es, Ww, Cv, Ww, Ww, Wo, Ww^Ewl, Wwf, Gs^Fds, Gs^Fds, Wo, Gs^Fds, Gg^Efm, Gs^Fds, Gg^Em, Gs^Fds, Gll^Fp, Gll^Fp, Gs^Fms, Gs^Fms, Gs^Fds
Gs, Gs^Efm, Gs^Efm, Gs, Gg^Efm, Gg^Efm, Gg^Efm, Gg, Gs^Fds, Gs^Efm, Gg, Wwf, Wwf^Es, Wwf, Ww, Wo, Gs^Efm, Wo, Wo, Ww, Ww^Ewf, Ww, Gs^Fds, Wo, Ww, Ww, Ww, Wwf, Wwf, Gs^Efm, Wwf^Es, Wo, Ww, Gs, Gs, Gs^Fds, Gg^Fet, Gll, Gll^Fp, Gll^Fp, Gs^Fds, Gs^Fds
Gs^Efm, Gg^Efm, Gg, Gs^Fds, Gs^Fds, Gs^Efm, Gs^Efm, Gg, Gs^Fds, Gs^Fds, Gs^Fds, Wwf, Gg^Em, Gs^Fds, Gg^Efm, Gs, Gs^Es, Ww, Ww, Wo, Ww, Ww, Wwf, Wo, Ww, Gs^Efm, Gs^Fds, Gg, Gs^Fds, Gs^Fds, Gs^Efm, Wwf, Wo, Gs^Efm, Ww, Gs, Gg, Gs^Fds, Gs^Fms, Gll^Em, Gs, Gs^Fds
Gs^Fds, Gs^Fds, Gs, Gs^Fds, Gll, Gs, Gs^Efm, Gs^Fds, Gg^Efm, Gs, Gg^Efm, Gs^Fds, Gs^Fds, Gs^Fds, Gs^Fds, Gs^Fds, Wwf, Wwf, Gg, Ww, Gs^Fds, Wwf, Gs^Efm, Ww, Gs^Fds, Gg^Em, Gs^Fds, Gs^Fds, Gs^Fds, Gs^Efm, Gs^Fds, Gs^Fds, Gs^Es, Ww, Wo, Ww^Ewl, Gg, Gs^Fds, Gs^Fds, Gs^Fms, Gs^Fds, Gs^Fds
Gs^Fds, Gg^Em, Gs^Fms, Gll^Fp, Gll^Fp, Gs^Fms, Gs^Efm, Gs, Sm, Ss, Gs^Fds, Gs^Efm, Gs^Fds, Gs^Fds, Gs, Gg^Efm, Gg^Efm, Gg, Gs^Fds, Gs^Efm, Gs^Fds, Sm, Ss, Gg, Gs^Fds, Gs^Fds, Gg^Efm, Gs^Fds, Gs^Fds, Gg, Gg^Efm, Sm, Wwf, Ww, Ww, Wo, Wwf^Es, Sm, Gg, Gg^Ve, Gs^Fds, Gs^Fds
Gs^Fds, Gs^Fms, Gll^Fp, Gll^Fp, Gs^Fms, Gll^Fp, Gg^Efm, Ww, Gg, Sm, Gs, Gs^Fds, Gs^Fds, Gs^Fds, Gs^Fds, Gs^Fds, Gs^Fds, Gs^Fds, Gs^Fds, Gg^Efm, Gg^Efm, Gg, Gg^Efm, Gs^Fds, Gg^Efm, Gs^Fds, Gs^Fds, Gg^Efm, 1 Gs^Fds, Gs^Fds, Gs^Fds, Gs^Efm, Gs^Fds, Gs^Fds, Gg^Efm, Wo, Ww, Gg^Efm, Gs^Fds, Gs^Efm, Gs^Efm, Gs^Efm
Gs^Fds, Gs^Fds, Gs^Fds, Gll^Fp, Gs^Fds, Gs^Fds, Gg^Ve, Wwf, Gg^Efm, Gs^Es, Gg^Fet, Gs^Efm, Gs^Fds, Gs^Efm, Gg, Gs^Fds, Gs^Efm, Gs^Fds, Gs^Fds, Gg, Gs^Fds, Gs^Fds, Gs^Fds, Gs^Fds, Gs^Fds, Gg^Ve, Gs, Gs^Efm, Gg, Gs^Fds, Gs, 2 Gs^Fds, Gs^Fds, Gs^Fds, Gs^Fds, Ww^Ewf, Wo, Ww, Gs^Fds, Gs^Fds, Gs^Efm, Gs^Fds
Gs^Fds, Gs^Fds, Gs^Fds, Gs^Efm, Gg^Em, Gs, Gs^Efm, Gs^Efm, Gg, Gg, Gs, Gs^Fds, Gs^Fds, Gs^Fds, Gs^Efm, Gg^Efm, Gs, Gg^Es, Gg, Gs^Fds, Gs^Fds, Gs^Fds, Gg^Em, Gs^Fds, Gs^Fds, Gs^Fds, Gs^Fds, Gs^Fds, Gs^Fds, Gs^Fds, Gs^Efm, Gs^Fds, Gg^Efm, Gs^Fds, Gs^Fds, Gs, Gs^Fds, Wo, Wo, Sm, Gs^Fds, Gs^Fds
Gs^Fds, Gs^Fds, Gs^Fds, Gs^Fds, Gs^Fds, Gg, Gs^Fds, Gg^Efm, Gg, Gs^Fds, Gs^Fds, Gs^Fds, Gg, Gs^Fds, Gs^Efm, Gg^Efm, Gs^Fds, Gs^Fds, Gg^Efm, Gg^Efm, Gs^Fds, Gs^Fds, Gs^Fds, Gs, Gg, Gs^Fds, Gs^Fds, Gs^Fds, Gg, Gs^Efm, Gg^Efm, Gs^Fds, Gs, Gs^Efm, Gs^Fds, Gs^Fds, Gs^Fds, Ww, Wo, Wwf, Ww, Gs^Fds
